ABC	ABCfirst-rate
a	aBCfirst-rate
aah	interjection; surprise, pleasure
aardvark	African earth-pig; animal that takes ants as food
aback	surpriseearth-pig; animal that takes ants as food
abandon	let goseearth-pig; animal that takes ants as food
abandoned	given upearth-pig; animal that takes ants as food
abandoning	giving uparth-pig; animal that takes ants as food
abandons	gives upparth-pig; animal that takes ants as food
abate	make lessarth-pig; animal that takes ants as food
abated	made lessarth-pig; animal that takes ants as food
abating	making lessth-pig; animal that takes ants as food
abbreviate	make shorterh-pig; animal that takes ants as food
abbreviated	make shorterh-pig; animal that takes ants as food
abbreviates	makes shorter-pig; animal that takes ants as food
abbreviating	making shorterpig; animal that takes ants as food
abbreviation	short formrterpig; animal that takes ants as food
abbreviations	short formsterpig; animal that takes ants as food
abdicate	give upormsterpig; animal that takes ants as food
abdicated	gave up; given up; animal that takes ants as food
abdicating	giving upgiven up; animal that takes ants as food
abduct	take awaygiven up; animal that takes ants as food
abducted	taken awayiven up; animal that takes ants as food
abducting	taking awayven up; animal that takes ants as food
abduction	taken awayyven up; animal that takes ants as food
abductor	one taking awayup; animal that takes ants as food
abeyance	not in present use animal that takes ants as food
abhor	hatein present use animal that takes ants as food
abhorred	hatedn present use animal that takes ants as food
abhorring	hating present use animal that takes ants as food
abide	keep topresent use animal that takes ants as food
abided	kept topresent use animal that takes ants as food
abides	keeps toresent use animal that takes ants as food
abiding	keeping tosent use animal that takes ants as food
abilities	powers toosent use animal that takes ants as food
ability	power tooosent use animal that takes ants as food
abject	poorr tooosent use animal that takes ants as food
abjectly	poorlytooosent use animal that takes ants as food
ablaze	in flamesosent use animal that takes ants as food
able	ablelamesosent use animal that takes ants as food
abled	abledamesosent use animal that takes ants as food
abler	ableramesosent use animal that takes ants as food
ablers	ablersmesosent use animal that takes ants as food
ablution	washingesosent use animal that takes ants as food
ablutions	washingssosent use animal that takes ants as food
abnormal	not normalsent use animal that takes ants as food
abnormally	not normallynt use animal that takes ants as food
aboard	ont normallynt use animal that takes ants as food
abode	living placent use animal that takes ants as food
abolish	put an end tot use animal that takes ants as food
abolished	put an end tot use animal that takes ants as food
abolishes	puts an end to use animal that takes ants as food
abolishing	putting an end toe animal that takes ants as food
abolition	an end; end of SLAVERYmal that takes ants as food
abominable	very badend of SLAVERYmal that takes ants as food
abominably	very badlyd of SLAVERYmal that takes ants as food
abort	give birth before ready; come to an end (early)od
aborted	gave birth before ready; came to an end (early)od
aborting	giving birth before ready; coming to an end (early)
abortion	give birth to dead babydy; coming to an end (early)
abortions	give birth to dead babies; coming to an end (early)
abortive	that come to nothingabies; coming to an end (early)
aborts	gives birth before ready; comes to an end (early)y)
about	about birth before ready; comes to an end (early)y)
above	over; more thanore ready; comes to an end (early)y)
abreast	level more thanore ready; comes to an end (early)y)
abridgements	shorter formsanore ready; comes to an end (early)y)
abridgment	a shorter formnore ready; comes to an end (early)y)
abroad	in another country ready; comes to an end (early)y)
abrupt	suddenther country ready; comes to an end (early)y)
abruptly	suddenlyer country ready; comes to an end (early)y)
absence	not present; [second]ady; comes to an end (early)y)
absences	not present more than once; [second]n end (early)y)
absent	not present more than once; [second]n end (early)y)
absented	made not present than once; [second]n end (early)y)
absenting	making not present;an once; [second]n end (early)y)
absents	makes not presentt;an once; [second]n end (early)y)
absolute	completet presentt;an once; [second]n end (early)y)
absolutely	completelypresentt;an once; [second]n end (early)y)
absolve	make free fromentt;an once; [second]n end (early)y)
absolved	made free fromentt;an once; [second]n end (early)y)
absolving	making free fromtt;an once; [second]n end (early)y)
absorb	take upfree fromtt;an once; [second]n end (early)y)
absorbed	taken upree fromtt;an once; [second]n end (early)y)
absorbent	able to takefromtt;an once; [second]n end (early)y)
absorbing	keeping the attention once; [second]n end (early)y)
absorbs	takes upthe attention once; [second]n end (early)y)
absorption	being taken uptention once; [second]n end (early)y)
abstain	keep fromen uptention once; [second]n end (early)y)
abstained	kept fromen uptention once; [second]n end (early)y)
abstainer	person who takes no strong drinkond]n end (early)y)
abstaining	keeping fromakes no strong drinkond]n end (early)y)
abstemious	taking littlekes no strong drinkond]n end (early)y)
abstract	short account; make a short account; take fromly)y)
abstracted	made short; took from short account; take fromly)y)
abstracting	making a short account; taking from; take fromly)y)
abstraction	take out; idea, not fact"aking from; take fromly)y)
abstractly	having thoughts on other thingsfrom; take fromly)y)
abstracts	more than one short account; makes short account)y)
abstruse	out of the wayshort account; makes short account)y)
absurd	without reason; foolishount; makes short account)y)
absurdity	foolish thingn; foolishount; makes short account)y)
absurdly	foolishlyhingn; foolishount; makes short account)y)
abundance	more than enoughfoolishount; makes short account)y)
abundances	more than enoughfoolishount; makes short account)y)
abundant	more than enoughfoolishount; makes short account)y)
abuse	wrong use; make wrong use of makes short account)y)
abused	made wrong use ofrong use of makes short account)y)
abuser	one making wrong use ofse of makes short account)y)
abusers	persons making wrong use off makes short account)y)
abuses	wrong uses; make wrong uses ofakes short account)y)
abusing	making wrong use ofong uses ofakes short account)y)
abusive	having tendency of wrong useofakes short account)y)
abysmal	deep, without limit; very bad"akes short account)y)
academic	of a university; theory, not doing"short account)y)
academically	by theory onlyy; theory, not doing"short account)y)
academics	of a university; theories, not doing"ort account)y)
accelerate	increase in rate theories, not doing"ort account)y)
accelerated	increased in ratetheories, not doing"ort account)y)
accelerates	increases in ratetheories, not doing"ort account)y)
acceleration	increase in rateetheories, not doing"ort account)y)
accent	way of saying words; give weight to soundsccount)y)
accenting	way of saying words; giving weight tooundsccount)y)
accents	ways of saying words; give weights to soundsount)y)
accept	take; say yes (to offer)ve weights to soundsount)y)
acceptability	able to please, be pleasing; able to say yes (to offer)"
acceptable	pleasing; say yes (to offer) able to say yes (to offer)"
acceptance	taking; belief in; account of exchange; [business]ffer)"
acceptances	takings; beliefs in; accounts of exchange; [business]r)"
accepted	taken; tookliefs in; accounts of exchange; [business]r)"
accepting	willing; takings in; accounts of exchange; [business]r)"
accepts	takesng; takings in; accounts of exchange; [business]r)"
access	way in; make use of; accounts of exchange; [business]r)"
accessed	made way in; made use ofounts of exchange; [business]r)"
accesses	ways in; makes use of; makes way inchange; [business]r)"
accessible	able to be got toe of; makes way inchange; [business]r)"
accessing	making way in; making use of way inchange; [business]r)"
accessories	additionsy in; making use of way inchange; [business]r)"
accessory	helper in an actaking use of way inchange; [business]r)"
accident	chance event; [business, second] inchange; [business]r)"
accidental	unhappilyent; [business, second] inchange; [business]r)"
accidentally	unhappilyent; [business, second] inchange; [business]r)"
accidents	chance events; [business, second]inchange; [business]r)"
acclimatize	get used to new conditionssecond]inchange; [business]r)"
accommodate	give spaceo new conditionssecond]inchange; [business]r)"
accommodating	ready to do new conditionssecond]inchange; [business]r)"
accommodation	rooms to do new conditionssecond]inchange; [business]r)"
accompanied	withs to do new conditionssecond]inchange; [business]r)"
accompanies	withs to do new conditionssecond]inchange; [business]r)"
accompany	go witho do new conditionssecond]inchange; [business]r)"
accompanying	going witho new conditionssecond]inchange; [business]r)"
accomplice	person acting for anotherssecond]inchange; [business]r)"
accomplices	persons acting for othersssecond]inchange; [business]r)"
accomplish	dorsons acting for othersssecond]inchange; [business]r)"
accomplished	able to do things wellersssecond]inchange; [business]r)"
accomplishes	does to do things wellersssecond]inchange; [business]r)"
accomplishing	doingto do things wellersssecond]inchange; [business]r)"
accord	agreemento things wellersssecond]inchange; [business]r)"
accordance	agreemento things wellersssecond]inchange; [business]r)"
accorded	gave; giventhings wellersssecond]inchange; [business]r)"
according	if this account is rightsssecond]inchange; [business]r)"
accordingly	for that reason; as agreement; then; as an outcome of thatAöDÎçp¸
accords	agreementseason; as agreement; then; as an outcome of thatAöDÎçp¸
accost	go up totseason; as agreement; then; as an outcome of thatAöDÎçp¸
accosted	gone up toeason; as agreement; then; as an outcome of thatAöDÎçp¸
account	account toeason; as agreement; then; as an outcome of thatAöDÎçp¸
accountable	accountableason; as agreement; then; as an outcome of thatAöDÎçp¸
accountant	one expert at accountsreement; then; as an outcome of thatAöDÎçp¸
accountants	persons expert at accountsent; then; as an outcome of thatAöDÎçp¸
accounted	accountedxpert at accountsent; then; as an outcome of thatAöDÎçp¸
accounting	accountingpert at accountsent; then; as an outcome of thatAöDÎçp¸
accounting's	accounting'srt at accountsent; then; as an outcome of thatAöDÎçp¸
accounts	accountsng'srt at accountsent; then; as an outcome of thatAöDÎçp¸
accredited	creditedng'srt at accountsent; then; as an outcome of thatAöDÎçp¸
accumulate	make a store ofat accountsent; then; as an outcome of thatAöDÎçp¸
accumulated	stored store ofat accountsent; then; as an outcome of thatAöDÎçp¸
accumulates	stores store ofat accountsent; then; as an outcome of thatAöDÎçp¸
accumulating	gettingstore ofat accountsent; then; as an outcome of thatAöDÎçp¸
accumulation	storesgstore ofat accountsent; then; as an outcome of thatAöDÎçp¸
accumulative	greater by additionscountsent; then; as an outcome of thatAöDÎçp¸
accumulator	apparatus for storing electric currents an outcome of thatAöDÎçp¸
accuracy	having no errortoring electric currents an outcome of thatAöDÎçp¸
accurate	no erroro errortoring electric currents an outcome of thatAöDÎçp¸
accurately	without errorortoring electric currents an outcome of thatAöDÎçp¸
accusation	statement againstring electric currents an outcome of thatAöDÎçp¸
accusations	statements againsting electric currents an outcome of thatAöDÎçp¸
accuse	make a statement againstectric currents an outcome of thatAöDÎçp¸
accused	person with statement againstc currents an outcome of thatAöDÎçp¸
accuses	makes a statement againstinstc currents an outcome of thatAöDÎçp¸
accusing	making a statement againstnstc currents an outcome of thatAöDÎçp¸
accustom	get used toatement againstnstc currents an outcome of thatAöDÎçp¸
accustomed	gotten used toment againstnstc currents an outcome of thatAöDÎçp¸
accustoming	getting used toent againstnstc currents an outcome of thatAöDÎçp¸
accustoms	gets used to toent againstnstc currents an outcome of thatAöDÎçp¸
ace	very good to toent againstnstc currents an outcome of thatAöDÎçp¸
aced	make very goodoent againstnstc currents an outcome of thatAöDÎçp¸
ache	pain very goodoent againstnstc currents an outcome of thatAöDÎçp¸
aches	painsvery goodoent againstnstc currents an outcome of thatAöDÎçp¸
achieve	doinsvery goodoent againstnstc currents an outcome of thatAöDÎçp¸
achieved	donesvery goodoent againstnstc currents an outcome of thatAöDÎçp¸
achievement	thing donegoodoent againstnstc currents an outcome of thatAöDÎçp¸
achievements	things doneoodoent againstnstc currents an outcome of thatAöDÎçp¸
achiever	one doingneoodoent againstnstc currents an outcome of thatAöDÎçp¸
achieves	doesdoingneoodoent againstnstc currents an outcome of thatAöDÎçp¸
achieving	doingoingneoodoent againstnstc currents an outcome of thatAöDÎçp¸
acid	acidgoingneoodoent againstnstc currents an outcome of thatAöDÎçp¸
acidly	acidlyingneoodoent againstnstc currents an outcome of thatAöDÎçp¸
acknowledge	give credit forent againstnstc currents an outcome of thatAöDÎçp¸
acknowledged	given creditforent againstnstc currents an outcome of thatAöDÎçp¸
acknowledgement	given credit fornt againstnstc currents an outcome of thatAöDÎçp¸
acknowledgements	given credits fort againstnstc currents an outcome of thatAöDÎçp¸
acknowledges	gives credits fort againstnstc currents an outcome of thatAöDÎçp¸
acknowledging	giving credit fort againstnstc currents an outcome of thatAöDÎçp¸
acknowledgment	given credit forrt againstnstc currents an outcome of thatAöDÎçp¸
acknowledgments	given credits fort againstnstc currents an outcome of thatAöDÎçp¸
acorn	nuten credits fort againstnstc currents an outcome of thatAöDÎçp¸
acoustic	with soundits fort againstnstc currents an outcome of thatAöDÎçp¸
acquaint	get knowledge ofrt againstnstc currents an outcome of thatAöDÎçp¸
acquaintance	friend; person one has had meeting with an outcome of thatAöDÎçp¸
acquaintances	friends; persons one had meeting withth an outcome of thatAöDÎçp¸
acquiescence	agreementpersons one had meeting withth an outcome of thatAöDÎçp¸
acquire	geteementpersons one had meeting withth an outcome of thatAöDÎçp¸
acquired	gottenentpersons one had meeting withth an outcome of thatAöDÎçp¸
acquirement	got by learnings one had meeting withth an outcome of thatAöDÎçp¸
acquires	getsby learnings one had meeting withth an outcome of thatAöDÎçp¸
acquiring	gettinglearnings one had meeting withth an outcome of thatAöDÎçp¸
acquisition	thing gottenings one had meeting withth an outcome of thatAöDÎçp¸
acquisitive	got by learnings one had meeting withth an outcome of thatAöDÎçp¸
acquit	say is not in the wrongd meeting withth an outcome of thatAöDÎçp¸
acquittal	freed from wronge wrongd meeting withth an outcome of thatAöDÎçp¸
acquitted	said not wrongnge wrongd meeting withth an outcome of thatAöDÎçp¸
acre	unit of land measureongd meeting withth an outcome of thatAöDÎçp¸
acreage	country land measureongd meeting withth an outcome of thatAöDÎçp¸
acres	units of land measurengd meeting withth an outcome of thatAöDÎçp¸
acrid	bitingof land measurengd meeting withth an outcome of thatAöDÎçp¸
acrimonious	with bitter thoughtsengd meeting withth an outcome of thatAöDÎçp¸
acrimony	bitter thoughtsughtsengd meeting withth an outcome of thatAöDÎçp¸
acrobat	one who does tricks in the airng withth an outcome of thatAöDÎçp¸
acrobatic	tricks in the airks in the airng withth an outcome of thatAöDÎçp¸
acrobats	those who do tricks in the airng withth an outcome of thatAöDÎçp¸
acronym	word made from the first letters of a number of words thatAöDÎçp¸
acronyms	words made from the first letters of a number of wordsthatAöDÎçp¸
across	acrossmade from the first letters of a number of wordsthatAöDÎçp¸
act	actossmade from the first letters of a number of wordsthatAöDÎçp¸
acted	actedsmade from the first letters of a number of wordsthatAöDÎçp¸
acting	actingmade from the first letters of a number of wordsthatAöDÎçp¸
action	actingmade from the first letters of a number of wordsthatAöDÎçp¸
actionable	giving cause in law first letters of a number of wordsthatAöDÎçp¸
actions	actsng cause in law first letters of a number of wordsthatAöDÎçp¸
activate	put in operationlaw first letters of a number of wordsthatAöDÎçp¸
activated	put in operationlaw first letters of a number of wordsthatAöDÎçp¸
activates	puts in operationaw first letters of a number of wordsthatAöDÎçp¸
activating	putting in operationfirst letters of a number of wordsthatAöDÎçp¸
active	in operation; [science]st letters of a number of wordsthatAöDÎçp¸
actively	hard working; [science]st letters of a number of wordsthatAöDÎçp¸
activities	things done; operations; special actsa number of wordsthatAöDÎçp¸
activity	thing done; motion; a special actactsa number of wordsthatAöDÎçp¸
actor	actor done; motion; a special actactsa number of wordsthatAöDÎçp¸
actor's	actor'sone; motion; a special actactsa number of wordsthatAöDÎçp¸
actors	actorssone; motion; a special actactsa number of wordsthatAöDÎçp¸
actress	woman actor motion; a special actactsa number of wordsthatAöDÎçp¸
acts	actsn actor motion; a special actactsa number of wordsthatAöDÎçp¸
actual	in existence; true, in factal actactsa number of wordsthatAöDÎçp¸
actuality	factxistence; true, in factal actactsa number of wordsthatAöDÎçp¸
actually	in facttence; true, in factal actactsa number of wordsthatAöDÎçp¸
actuals	things in existence in factal actactsa number of wordsthatAöDÎçp¸
acute	sharps in existence in factal actactsa number of wordsthatAöDÎçp¸
adage	old sayingexistence in factal actactsa number of wordsthatAöDÎçp¸
adamant	unmovedingexistence in factal actactsa number of wordsthatAöDÎçp¸
adapt	make adjustmentence in factal actactsa number of wordsthatAöDÎçp¸
adaptable	adjustabletmentence in factal actactsa number of wordsthatAöDÎçp¸
adaptation	adjustmenttmentence in factal actactsa number of wordsthatAöDÎçp¸
adapted	made adjustmentence in factal actactsa number of wordsthatAöDÎçp¸
adapter	thing making adjustmentfactal actactsa number of wordsthatAöDÎçp¸
adapting	making adjustmentstmentfactal actactsa number of wordsthatAöDÎçp¸
adaptor	thing making adjustmentfactal actactsa number of wordsthatAöDÎçp¸
adapts	makes adjustmentustmentfactal actactsa number of wordsthatAöDÎçp¸
add	make an additionustmentfactal actactsa number of wordsthatAöDÎçp¸
added	made an additionustmentfactal actactsa number of wordsthatAöDÎçp¸
addendum	thing to be addedstmentfactal actactsa number of wordsthatAöDÎçp¸
addendums	things to be addedtmentfactal actactsa number of wordsthatAöDÎçp¸
adder	thing to make additiontfactal actactsa number of wordsthatAöDÎçp¸
adders	things to make additionfactal actactsa number of wordsthatAöDÎçp¸
addict	one with tendency; DRUG userl actactsa number of wordsthatAöDÎçp¸
addicted	given to tendency; DRUG userl actactsa number of wordsthatAöDÎçp¸
addicting	causing a tendency DRUG userl actactsa number of wordsthatAöDÎçp¸
addictive	causing a tendency DRUG userl actactsa number of wordsthatAöDÎçp¸
addicts	one with a tendency; DRUG usersctactsa number of wordsthatAöDÎçp¸
adding	adding; making an additionusersctactsa number of wordsthatAöDÎçp¸
addition	additionmaking an additionusersctactsa number of wordsthatAöDÎçp¸
additional	thing addeding an additionusersctactsa number of wordsthatAöDÎçp¸
additionally	in additioning an additionusersctactsa number of wordsthatAöDÎçp¸
additions	additionsoning an additionusersctactsa number of wordsthatAöDÎçp¸
addled	mixedionsoning an additionusersctactsa number of wordsthatAöDÎçp¸
address	one's house; public talk; placectactsa number of wordsthatAöDÎçp¸
addressed	made house numbers; talked in publicsa number of wordsthatAöDÎçp¸
addresses	one's houses; public talks; placesicsa number of wordsthatAöDÎçp¸
addressing	writing house numbers; talkingacesicsa number of wordsthatAöDÎçp¸
adds	makes an additionbers; talkingacesicsa number of wordsthatAöDÎçp¸
adept	expertan additionbers; talkingacesicsa number of wordsthatAöDÎçp¸
adeptly	expertly additionbers; talkingacesicsa number of wordsthatAöDÎçp¸
adequacy	enoughly additionbers; talkingacesicsa number of wordsthatAöDÎçp¸
adequate	enough; ableitionbers; talkingacesicsa number of wordsthatAöDÎçp¸
adequately	with necessary qualities; with enougha number of wordsthatAöDÎçp¸
adhere	be fixed; keep toalities; with enougha number of wordsthatAöDÎçp¸
adhered	fixed; kept to toalities; with enougha number of wordsthatAöDÎçp¸
adherence	take as rule; keeping to; with enougha number of wordsthatAöDÎçp¸
adherent	supporterule; keeping to; with enougha number of wordsthatAöDÎçp¸
adheres	is fixed; keeps toing to; with enougha number of wordsthatAöDÎçp¸
adhering	being fixed; keeping too; with enougha number of wordsthatAöDÎçp¸
adhesion	being fixed; keeping too; with enougha number of wordsthatAöDÎçp¸
adhesive	stickyfixed; keeping too; with enougha number of wordsthatAöDÎçp¸
adjacent	nearest; [science]ng too; with enougha number of wordsthatAöDÎçp¸
adjective	named quality; word making adjustment to a thing wordsthatAöDÎçp¸
adjectives	words giving qualitiesking adjustment to a thing wordsthatAöDÎçp¸
adjoining	touchingving qualitiesking adjustment to a thing wordsthatAöDÎçp¸
adjourn	put off to a later time; enddjustment to a thing wordsthatAöDÎçp¸
adjourned	put off; endedater time; enddjustment to a thing wordsthatAöDÎçp¸
adjourning	putting off; endingtime; enddjustment to a thing wordsthatAöDÎçp¸
adjudicate	judgeng off; endingtime; enddjustment to a thing wordsthatAöDÎçp¸
adjudicated	judgedg off; endingtime; enddjustment to a thing wordsthatAöDÎçp¸
adjudicating	judging off; endingtime; enddjustment to a thing wordsthatAöDÎçp¸
adjudicator	judgeng off; endingtime; enddjustment to a thing wordsthatAöDÎçp¸
adjunct	dependentff; endingtime; enddjustment to a thing wordsthatAöDÎçp¸
adjust	adjustentff; endingtime; enddjustment to a thing wordsthatAöDÎçp¸
adjusted	adjustingff; endingtime; enddjustment to a thing wordsthatAöDÎçp¸
adjuster	adjustergff; endingtime; enddjustment to a thing wordsthatAöDÎçp¸
adjusters	adjustersff; endingtime; enddjustment to a thing wordsthatAöDÎçp¸
adjusting	adjustingff; endingtime; enddjustment to a thing wordsthatAöDÎçp¸
adjustment	adjustmentf; endingtime; enddjustment to a thing wordsthatAöDÎçp¸
adjustments	adjustments; endingtime; enddjustment to a thing wordsthatAöDÎçp¸
adjusts	adjustsents; endingtime; enddjustment to a thing wordsthatAöDÎçp¸
adjutant	helpersents; endingtime; enddjustment to a thing wordsthatAöDÎçp¸
administer	have control of government; givetment to a thing wordsthatAöDÎçp¸
administered	controlledol of government; givetment to a thing wordsthatAöDÎçp¸
administering	controllingl of government; givetment to a thing wordsthatAöDÎçp¸
administers	controlsingl of government; givetment to a thing wordsthatAöDÎçp¸
administration	the governmentf government; givetment to a thing wordsthatAöDÎçp¸
administrative	office operationsovernment; givetment to a thing wordsthatAöDÎçp¸
admirable	very gooderationsovernment; givetment to a thing wordsthatAöDÎçp¸
admiral	sea force authorityernment; givetment to a thing wordsthatAöDÎçp¸
admiralty	branch controlling sea forcesivetment to a thing wordsthatAöDÎçp¸
admiration	respect; approvalg sea forcesivetment to a thing wordsthatAöDÎçp¸
admire	have a high opinion; give approvalent to a thing wordsthatAöDÎçp¸
admired	had high opinionion; give approvalent to a thing wordsthatAöDÎçp¸
admirer	one having high opinionve approvalent to a thing wordsthatAöDÎçp¸
admiring	approvingg high opinionve approvalent to a thing wordsthatAöDÎçp¸
admissible	have the right to useonve approvalent to a thing wordsthatAöDÎçp¸
admission	statement against ones willpprovalent to a thing wordsthatAöDÎçp¸
admit	let in; make statement willpprovalent to a thing wordsthatAöDÎçp¸
admits	lets in; makes statementillpprovalent to a thing wordsthatAöDÎçp¸
admittance	be let inmakes statementillpprovalent to a thing wordsthatAöDÎçp¸
admitted	let in; made statementntillpprovalent to a thing wordsthatAöDÎçp¸
admittedly	with a statementtementntillpprovalent to a thing wordsthatAöDÎçp¸
admitting	letting in; making statementprovalent to a thing wordsthatAöDÎçp¸
admixture	mixedng in; making statementprovalent to a thing wordsthatAöDÎçp¸
admonish	protest wrongdoing statementprovalent to a thing wordsthatAöDÎçp¸
ado	trouble wrongdoing statementprovalent to a thing wordsthatAöDÎçp¸
adobe	sun dried bricking statementprovalent to a thing wordsthatAöDÎçp¸
adolescence	late stage of youthstatementprovalent to a thing wordsthatAöDÎçp¸
adolescent	young personf youthstatementprovalent to a thing wordsthatAöDÎçp¸
adolescents	young persons youthstatementprovalent to a thing wordsthatAöDÎçp¸
adopt	take upersons youthstatementprovalent to a thing wordsthatAöDÎçp¸
adopted	took upersons youthstatementprovalent to a thing wordsthatAöDÎçp¸
adopting	taking upsons youthstatementprovalent to a thing wordsthatAöDÎçp¸
adoption	taking as one's childatementprovalent to a thing wordsthatAöDÎçp¸
adoptive	taken ups one's childatementprovalent to a thing wordsthatAöDÎçp¸
adopts	takes ups one's childatementprovalent to a thing wordsthatAöDÎçp¸
adorable	causing lovee's childatementprovalent to a thing wordsthatAöDÎçp¸
adore	have great love forldatementprovalent to a thing wordsthatAöDÎçp¸
adorn	put on ornament forldatementprovalent to a thing wordsthatAöDÎçp¸
adorning	putting on ornamentldatementprovalent to a thing wordsthatAöDÎçp¸
adornment	ornamenton ornamentldatementprovalent to a thing wordsthatAöDÎçp¸
adrift	out of controlamentldatementprovalent to a thing wordsthatAöDÎçp¸
adroit	quick; expertlamentldatementprovalent to a thing wordsthatAöDÎçp¸
adsorption	join of substance on a body; [science]to a thing wordsthatAöDÎçp¸
adult	man or woman; with full growthscience]to a thing wordsthatAöDÎçp¸
adulterate	put other substances intorowthscience]to a thing wordsthatAöDÎçp¸
adulterous	sex with marriednces intorowthscience]to a thing wordsthatAöDÎçp¸
adultery	being untrueriednces intorowthscience]to a thing wordsthatAöDÎçp¸
adults	men or womenriednces intorowthscience]to a thing wordsthatAöDÎçp¸
advance	step forward; increasentorowthscience]to a thing wordsthatAöDÎçp¸
advanced	stepped forward; increasedowthscience]to a thing wordsthatAöDÎçp¸
advances	moves forwardrd; increasedowthscience]to a thing wordsthatAöDÎçp¸
advancing	moving forwardd; increasedowthscience]to a thing wordsthatAöDÎçp¸
advantage	something to one's profit; good point]to a thing wordsthatAöDÎçp¸
advantageous	giving better chancerofit; good point]to a thing wordsthatAöDÎçp¸
advantages	things to one's profit; good pointsnt]to a thing wordsthatAöDÎçp¸
advent	coming; month before Christmasointsnt]to a thing wordsthatAöDÎçp¸
adventure	experience of great interestasointsnt]to a thing wordsthatAöDÎçp¸
adventurer	one ready for any chancerestasointsnt]to a thing wordsthatAöDÎçp¸
adventures	experiences of great interestsointsnt]to a thing wordsthatAöDÎçp¸
adventuresome	ready for experience interestsointsnt]to a thing wordsthatAöDÎçp¸
adventurous	ready for experience interestsointsnt]to a thing wordsthatAöDÎçp¸
adverb	word making an act clearerestsointsnt]to a thing wordsthatAöDÎçp¸
adversary	person fighting against onestsointsnt]to a thing wordsthatAöDÎçp¸
adverse	going againstng against onestsointsnt]to a thing wordsthatAöDÎçp¸
adversely	againstgainstng against onestsointsnt]to a thing wordsthatAöDÎçp¸
adversities	troublesainstng against onestsointsnt]to a thing wordsthatAöDÎçp¸
adversity	bad timesinstng against onestsointsnt]to a thing wordsthatAöDÎçp¸
advert	say aboutinstng against onestsointsnt]to a thing wordsthatAöDÎçp¸
advertise	give advertisementainst onestsointsnt]to a thing wordsthatAöDÎçp¸
advertised	advertisedtisementainst onestsointsnt]to a thing wordsthatAöDÎçp¸
advertisement	advertisementementainst onestsointsnt]to a thing wordsthatAöDÎçp¸
advertisements	advertisementsmentainst onestsointsnt]to a thing wordsthatAöDÎçp¸
advertiser	one making advertisementonestsointsnt]to a thing wordsthatAöDÎçp¸
advertisers	advertisersadvertisementonestsointsnt]to a thing wordsthatAöDÎçp¸
advertises	gives advertisementementonestsointsnt]to a thing wordsthatAöDÎçp¸
advertising	giving advertisementmentonestsointsnt]to a thing wordsthatAöDÎçp¸
adverts	says aboutertisementmentonestsointsnt]to a thing wordsthatAöDÎçp¸
advice	opinion; [second]entmentonestsointsnt]to a thing wordsthatAöDÎçp¸
advisable	wiseion; [second]entmentonestsointsnt]to a thing wordsthatAöDÎçp¸
advise	give opinioncond]entmentonestsointsnt]to a thing wordsthatAöDÎçp¸
advised	well-judgedncond]entmentonestsointsnt]to a thing wordsthatAöDÎçp¸
adviser	one giving opinionntmentonestsointsnt]to a thing wordsthatAöDÎçp¸
advisers	persons giving opinionntonestsointsnt]to a thing wordsthatAöDÎçp¸
advises	gives opiniong opinionntonestsointsnt]to a thing wordsthatAöDÎçp¸
advising	giving opinion opinionntonestsointsnt]to a thing wordsthatAöDÎçp¸
advisor	one giving opinionnionntonestsointsnt]to a thing wordsthatAöDÎçp¸
advisory	giving opinionnionnionntonestsointsnt]to a thing wordsthatAöDÎçp¸
advocacy	supportingnionnionnionntonestsointsnt]to a thing wordsthatAöDÎçp¸
advocate	supporter; give supporttonestsointsnt]to a thing wordsthatAöDÎçp¸
advocated	supported; gave supporttonestsointsnt]to a thing wordsthatAöDÎçp¸
advocates	supports; gives supporttonestsointsnt]to a thing wordsthatAöDÎçp¸
advocating	supporting; giving supportestsointsnt]to a thing wordsthatAöDÎçp¸
adz	hand instrument for taking off woodnt]to a thing wordsthatAöDÎçp¸
aerial	of air; intaket for taking off woodnt]to a thing wordsthatAöDÎçp¸
aerobatics	trick done with airplaneng off woodnt]to a thing wordsthatAöDÎçp¸
aerodrome	airplane fieldh airplaneng off woodnt]to a thing wordsthatAöDÎçp¸
aerodynamics	science of air in motionng off woodnt]to a thing wordsthatAöDÎçp¸
aesthetic	to do with art valuesionng off woodnt]to a thing wordsthatAöDÎçp¸
aesthetically	of art valuert valuesionng off woodnt]to a thing wordsthatAöDÎçp¸
afar	far awayaluert valuesionng off woodnt]to a thing wordsthatAöDÎçp¸
affable	kindawayaluert valuesionng off woodnt]to a thing wordsthatAöDÎçp¸
affair	business; love experienceg off woodnt]to a thing wordsthatAöDÎçp¸
affairs	love experiencesxperienceg off woodnt]to a thing wordsthatAöDÎçp¸
affect	have an effect onperienceg off woodnt]to a thing wordsthatAöDÎçp¸
affectation	false airsfect onperienceg off woodnt]to a thing wordsthatAöDÎçp¸
affected	not naturalect onperienceg off woodnt]to a thing wordsthatAöDÎçp¸
affecting	feelingsralect onperienceg off woodnt]to a thing wordsthatAöDÎçp¸
affection	loveingsralect onperienceg off woodnt]to a thing wordsthatAöDÎçp¸
affectionate	lovinggsralect onperienceg off woodnt]to a thing wordsthatAöDÎçp¸
affects	has an effect onnperienceg off woodnt]to a thing wordsthatAöDÎçp¸
affidavit	said true before authority off woodnt]to a thing wordsthatAöDÎçp¸
affiliate	make connection with; branch of organizationhing wordsthatAöDÎçp¸
affiliated	made connection with; branch of organizationhing wordsthatAöDÎçp¸
affiliater	joineronnection with; branch of organizationhing wordsthatAöDÎçp¸
affiliates	makes connection with; branches of organizationg wordsthatAöDÎçp¸
affiliating	making connection with branches of organizationg wordsthatAöDÎçp¸
affinity	relationonnection with branches of organizationg wordsthatAöDÎçp¸
affirm	state strongly; say in agreementof organizationg wordsthatAöDÎçp¸
affirmation	statementongly; say in agreementof organizationg wordsthatAöDÎçp¸
affirmative	answering Yesy; say in agreementof organizationg wordsthatAöDÎçp¸
affirmed	stated strongly; said in agreement organizationg wordsthatAöDÎçp¸
affirming	stating strongly; saying in agreementganizationg wordsthatAöDÎçp¸
affirmingly	being in agreementsaying in agreementganizationg wordsthatAöDÎçp¸
affirms	states strongly; says in agreemententganizationg wordsthatAöDÎçp¸
affix	fixtes strongly; says in agreemententganizationg wordsthatAöDÎçp¸
afflict	give painrongly; says in agreemententganizationg wordsthatAöDÎçp¸
affliction	pain; troublely; says in agreemententganizationg wordsthatAöDÎçp¸
affluence	being well offy; says in agreemententganizationg wordsthatAöDÎçp¸
affluent	well-offll offy; says in agreemententganizationg wordsthatAöDÎçp¸
afford	have enough; givesays in agreemententganizationg wordsthatAöDÎçp¸
affording	having enough; giving in agreemententganizationg wordsthatAöDÎçp¸
affront	unkind wordsh; giving in agreemententganizationg wordsthatAöDÎçp¸
afghanistan	Afghanistansh; giving in agreemententganizationg wordsthatAöDÎçp¸
afield	in the field; awaying in agreemententganizationg wordsthatAöDÎçp¸
afire	on firefield; awaying in agreemententganizationg wordsthatAöDÎçp¸
aflame	in flameseld; awaying in agreemententganizationg wordsthatAöDÎçp¸
afloat	at sea; on the waterg in agreemententganizationg wordsthatAöDÎçp¸
afoot	on foot on the waterg in agreemententganizationg wordsthatAöDÎçp¸
afore	beforet on the waterg in agreemententganizationg wordsthatAöDÎçp¸
afore-	beforet on the waterg in agreemententganizationg wordsthatAöDÎçp¸
aforementioned	said before; named beforeagreemententganizationg wordsthatAöDÎçp¸
aforesaid	named before; said beforeagreemententganizationg wordsthatAöDÎçp¸
afraid	in fear of; in fearbeforeagreemententganizationg wordsthatAöDÎçp¸
afresh	againar of; in fearbeforeagreemententganizationg wordsthatAöDÎçp¸
afrikaans	Afrikaansf; in fearbeforeagreemententganizationg wordsthatAöDÎçp¸
afrikaner	Afrikanerf; in fearbeforeagreemententganizationg wordsthatAöDÎçp¸
aft	back of shipin fearbeforeagreemententganizationg wordsthatAöDÎçp¸
after	afterof shipin fearbeforeagreemententganizationg wordsthatAöDÎçp¸
aftereffect	aftereffectpin fearbeforeagreemententganizationg wordsthatAöDÎçp¸
aftereffects	aftereffectsin fearbeforeagreemententganizationg wordsthatAöDÎçp¸
afterglow	last lighttsin fearbeforeagreemententganizationg wordsthatAöDÎçp¸
aftering	afteringhttsin fearbeforeagreemententganizationg wordsthatAöDÎçp¸
aftermath	outcomeghttsin fearbeforeagreemententganizationg wordsthatAöDÎçp¸
afternoon	after 12 a.m.; after morningeemententganizationg wordsthatAöDÎçp¸
afternoons	times after 12 a.m.r morningeemententganizationg wordsthatAöDÎçp¸
afters	aftersafter 12 a.m.r morningeemententganizationg wordsthatAöDÎçp¸
aftertaste	aftertaster 12 a.m.r morningeemententganizationg wordsthatAöDÎçp¸
aftertastes	aftertastes 12 a.m.r morningeemententganizationg wordsthatAöDÎçp¸
afterthought	afterthought12 a.m.r morningeemententganizationg wordsthatAöDÎçp¸
afterthoughts	afterthoughts2 a.m.r morningeemententganizationg wordsthatAöDÎçp¸
afterward	after; laters2 a.m.r morningeemententganizationg wordsthatAöDÎçp¸
afterwards	after; laters2 a.m.r morningeemententganizationg wordsthatAöDÎçp¸
again	again; laters2 a.m.r morningeemententganizationg wordsthatAöDÎçp¸
against	againstlaters2 a.m.r morningeemententganizationg wordsthatAöDÎçp¸
agape	wide openters2 a.m.r morningeemententganizationg wordsthatAöDÎçp¸
age	number of years old; time in existenceanizationg wordsthatAöDÎçp¸
aged	very old; [science, second]n existenceanizationg wordsthatAöDÎçp¸
ageing	becoming old; getting oldd]n existenceanizationg wordsthatAöDÎçp¸
ageless	never getting old; [science] existenceanizationg wordsthatAöDÎçp¸
agelong	going on for a long time; [science]nceanizationg wordsthatAöDÎçp¸
agency	business house; instrument; [business]anizationg wordsthatAöDÎçp¸
agenda	list of things for discussionbusiness]anizationg wordsthatAöDÎçp¸
agent	representative; [business, second]ess]anizationg wordsthatAöDÎçp¸
agents	representatives; [business, second]ss]anizationg wordsthatAöDÎçp¸
ages	a long time; [science, second]cond]ss]anizationg wordsthatAöDÎçp¸
agglomerate	get together looselye, second]cond]ss]anizationg wordsthatAöDÎçp¸
aggrandize	make more importantye, second]cond]ss]anizationg wordsthatAöDÎçp¸
aggravate	make more badortantye, second]cond]ss]anizationg wordsthatAöDÎçp¸
aggravation	thing causing angerye, second]cond]ss]anizationg wordsthatAöDÎçp¸
aggregate	mass; forming a group, second]cond]ss]anizationg wordsthatAöDÎçp¸
aggression	attack without causep, second]cond]ss]anizationg wordsthatAöDÎçp¸
aggressive	warlikewithout causep, second]cond]ss]anizationg wordsthatAöDÎçp¸
aggressor	one making attack without causeond]ss]anizationg wordsthatAöDÎçp¸
aggrieved	wounded in feelingsithout causeond]ss]anizationg wordsthatAöDÎçp¸
aghast	in surprise and fearthout causeond]ss]anizationg wordsthatAöDÎçp¸
agile	quick-movingand fearthout causeond]ss]anizationg wordsthatAöDÎçp¸
aging	getting old; [science, second]eond]ss]anizationg wordsthatAöDÎçp¸
agitate	put in motion[science, second]eond]ss]anizationg wordsthatAöDÎçp¸
agitated	put in motion[science, second]eond]ss]anizationg wordsthatAöDÎçp¸
agitation	troubled conditionnce, second]eond]ss]anizationg wordsthatAöDÎçp¸
agitator	one making troublence, second]eond]ss]anizationg wordsthatAöDÎçp¸
agley	with quick motionsnce, second]eond]ss]anizationg wordsthatAöDÎçp¸
ago	before; [second]nsnce, second]eond]ss]anizationg wordsthatAöDÎçp¸
agonies	painse; [second]nsnce, second]eond]ss]anizationg wordsthatAöDÎçp¸
agonize	give, have great pain, second]eond]ss]anizationg wordsthatAöDÎçp¸
agonized	gave, had great painn, second]eond]ss]anizationg wordsthatAöDÎçp¸
agonizes	gives, has great pain, second]eond]ss]anizationg wordsthatAöDÎçp¸
agonizing	giving, having great paincond]eond]ss]anizationg wordsthatAöDÎçp¸
agony	great painving great paincond]eond]ss]anizationg wordsthatAöDÎçp¸
agrarian	with farm-land great paincond]eond]ss]anizationg wordsthatAöDÎçp¸
agree	be in agreementgreat paincond]eond]ss]anizationg wordsthatAöDÎçp¸
agreeable	pleasingreementgreat paincond]eond]ss]anizationg wordsthatAöDÎçp¸
agreed	in agreemententgreat paincond]eond]ss]anizationg wordsthatAöDÎçp¸
agreeing	being in agreementat paincond]eond]ss]anizationg wordsthatAöDÎçp¸
agreement	agreementagreementat paincond]eond]ss]anizationg wordsthatAöDÎçp¸
agreements	agreementsgreementat paincond]eond]ss]anizationg wordsthatAöDÎçp¸
agrees	is in agreemententat paincond]eond]ss]anizationg wordsthatAöDÎçp¸
agricultural	farminggreemententat paincond]eond]ss]anizationg wordsthatAöDÎçp¸
agriculture	farminggreemententat paincond]eond]ss]anizationg wordsthatAöDÎçp¸
aground	fixed on edge of wateraincond]eond]ss]anizationg wordsthatAöDÎçp¸
ahead	in front edge of wateraincond]eond]ss]anizationg wordsthatAöDÎçp¸
aid	helpront edge of wateraincond]eond]ss]anizationg wordsthatAöDÎçp¸
aide	secretaryedge of wateraincond]eond]ss]anizationg wordsthatAöDÎçp¸
aide-de-camp	military secretaryateraincond]eond]ss]anizationg wordsthatAöDÎçp¸
aided	helpedry secretaryateraincond]eond]ss]anizationg wordsthatAöDÎçp¸
aiding	helpingy secretaryateraincond]eond]ss]anizationg wordsthatAöDÎçp¸
aids	helpsngy secretaryateraincond]eond]ss]anizationg wordsthatAöDÎçp¸
ail	be illgy secretaryateraincond]eond]ss]anizationg wordsthatAöDÎçp¸
ailing	being illsecretaryateraincond]eond]ss]anizationg wordsthatAöDÎçp¸
ailment	diseasellsecretaryateraincond]eond]ss]anizationg wordsthatAöDÎçp¸
aim	direction; purposeateraincond]eond]ss]anizationg wordsthatAöDÎçp¸
aimed	directed; with purpose ofcond]eond]ss]anizationg wordsthatAöDÎçp¸
aiming	pointing; with purpose ofcond]eond]ss]anizationg wordsthatAöDÎçp¸
aims	purposes; with purpose ofcond]eond]ss]anizationg wordsthatAöDÎçp¸
air	airposes; with purpose ofcond]eond]ss]anizationg wordsthatAöDÎçp¸
airbag	airbages; with purpose ofcond]eond]ss]anizationg wordsthatAöDÎçp¸
airbags	airbagss; with purpose ofcond]eond]ss]anizationg wordsthatAöDÎçp¸
aircraft	airplanes with purpose ofcond]eond]ss]anizationg wordsthatAöDÎçp¸
aircushion	aircushionwith purpose ofcond]eond]ss]anizationg wordsthatAöDÎçp¸
aircushioned	aircushionedth purpose ofcond]eond]ss]anizationg wordsthatAöDÎçp¸
aircushioning	aircushioningh purpose ofcond]eond]ss]anizationg wordsthatAöDÎçp¸
airily	not seriouslyh purpose ofcond]eond]ss]anizationg wordsthatAöDÎçp¸
airline	air-transport companye ofcond]eond]ss]anizationg wordsthatAöDÎçp¸
airmail	airmailnsport companye ofcond]eond]ss]anizationg wordsthatAöDÎçp¸
airman	airmanlnsport companye ofcond]eond]ss]anizationg wordsthatAöDÎçp¸
airmen	airmenlnsport companye ofcond]eond]ss]anizationg wordsthatAöDÎçp¸
airplane	airplanesport companye ofcond]eond]ss]anizationg wordsthatAöDÎçp¸
airplanes	airplanesport companye ofcond]eond]ss]anizationg wordsthatAöDÎçp¸
airport	airplane stationmpanye ofcond]eond]ss]anizationg wordsthatAöDÎçp¸
airports	airplane stationspanye ofcond]eond]ss]anizationg wordsthatAöDÎçp¸
airs	airslane stationspanye ofcond]eond]ss]anizationg wordsthatAöDÎçp¸
airtight	not letting air inanye ofcond]eond]ss]anizationg wordsthatAöDÎçp¸
airy	open to air air inanye ofcond]eond]ss]anizationg wordsthatAöDÎçp¸
aisle	way between seatsnanye ofcond]eond]ss]anizationg wordsthatAöDÎçp¸
ajar	a little openeatsnanye ofcond]eond]ss]anizationg wordsthatAöDÎçp¸
akin	having a family relationfcond]eond]ss]anizationg wordsthatAöDÎçp¸
alabama	Alabamaa family relationfcond]eond]ss]anizationg wordsthatAöDÎçp¸
alabaster	sort of white stone used for ornamentsanizationg wordsthatAöDÎçp¸
alacrity	being ready to do a thingfor ornamentsanizationg wordsthatAöDÎçp¸
alarm	fear; danger sign a thingfor ornamentsanizationg wordsthatAöDÎçp¸
alarmed	caused fearr sign a thingfor ornamentsanizationg wordsthatAöDÎçp¸
alarming	causing fear sign a thingfor ornamentsanizationg wordsthatAöDÎçp¸
alarms	put in fear; danger signsfor ornamentsanizationg wordsthatAöDÎçp¸
alas	cry of troubleanger signsfor ornamentsanizationg wordsthatAöDÎçp¸
albania	Albaniatroubleanger signsfor ornamentsanizationg wordsthatAöDÎçp¸
albatross	great white sea-bird; weight ornamentsanizationg wordsthatAöDÎçp¸
albeit	though; tho sea-bird; weight ornamentsanizationg wordsthatAöDÎçp¸
albino	without natural color weight ornamentsanizationg wordsthatAöDÎçp¸
album	book of picturescolor weight ornamentsanizationg wordsthatAöDÎçp¸
albumen	white of eggurescolor weight ornamentsanizationg wordsthatAöDÎçp¸
albums	books of picturesolor weight ornamentsanizationg wordsthatAöDÎçp¸
alchemy	early chemistryesolor weight ornamentsanizationg wordsthatAöDÎçp¸
alcohol	alcoholhemistryesolor weight ornamentsanizationg wordsthatAöDÎçp¸
alcohol's	alcohol'smistryesolor weight ornamentsanizationg wordsthatAöDÎçp¸
alcoholic	having alcohol; person who drinks muchanizationg wordsthatAöDÎçp¸
alcoholics	persons who drink to mucho drinks muchanizationg wordsthatAöDÎçp¸
alcohols	alcoholswho drink to mucho drinks muchanizationg wordsthatAöDÎçp¸
alcove	addition to roomk to mucho drinks muchanizationg wordsthatAöDÎçp¸
alderman	one of governing bodymucho drinks muchanizationg wordsthatAöDÎçp¸
ale	beerof governing bodymucho drinks muchanizationg wordsthatAöDÎçp¸
alert	readyf governing bodymucho drinks muchanizationg wordsthatAöDÎçp¸
ales	beersf governing bodymucho drinks muchanizationg wordsthatAöDÎçp¸
alfalfa	plant food for animalsucho drinks muchanizationg wordsthatAöDÎçp¸
algebra	algebraood for animalsucho drinks muchanizationg wordsthatAöDÎçp¸
algebraic	algebraood for animalsucho drinks muchanizationg wordsthatAöDÎçp¸
algeria	Algeriaood for animalsucho drinks muchanizationg wordsthatAöDÎçp¸
algorithm	systems for working out answersks muchanizationg wordsthatAöDÎçp¸
algorithms	system for working out answerssks muchanizationg wordsthatAöDÎçp¸
alias	with another nameg out answerssks muchanizationg wordsthatAöDÎçp¸
aliases	with other nameseg out answerssks muchanizationg wordsthatAöDÎçp¸
alibi	being in another place answerssks muchanizationg wordsthatAöDÎçp¸
alien	person of a different nation; strangehanizationg wordsthatAöDÎçp¸
aliens	persons of a different nation; strangersizationg wordsthatAöDÎçp¸
alight	get off; burningferent nation; strangersizationg wordsthatAöDÎçp¸
align	get into lineingferent nation; strangersizationg wordsthatAöDÎçp¸
aligned	got into lineingferent nation; strangersizationg wordsthatAöDÎçp¸
aligning	getting into lineerent nation; strangersizationg wordsthatAöDÎçp¸
alignment	into linento lineerent nation; strangersizationg wordsthatAöDÎçp¸
aligns	gets into lineineerent nation; strangersizationg wordsthatAöDÎçp¸
alike	the sameo lineineerent nation; strangersizationg wordsthatAöDÎçp¸
aliment	foodsameo lineineerent nation; strangersizationg wordsthatAöDÎçp¸
alimony	supporting when no longer marriedrangersizationg wordsthatAöDÎçp¸
alive	livingting when no longer marriedrangersizationg wordsthatAöDÎçp¸
all	allingting when no longer marriedrangersizationg wordsthatAöDÎçp¸
allay	make lessg when no longer marriedrangersizationg wordsthatAöDÎçp¸
allegation	something put forward without factsngersizationg wordsthatAöDÎçp¸
allegations	things put forward without factsctsngersizationg wordsthatAöDÎçp¸
allege	put forward as factwithout factsctsngersizationg wordsthatAöDÎçp¸
alleged	said to be sos factwithout factsctsngersizationg wordsthatAöDÎçp¸
allegedly	said to be so; doubtedhout factsctsngersizationg wordsthatAöDÎçp¸
alleges	says to be so; doubtedhout factsctsngersizationg wordsthatAöDÎçp¸
allegiance	support and respecttedhout factsctsngersizationg wordsthatAöDÎçp¸
alleging	saying to be sopecttedhout factsctsngersizationg wordsthatAöDÎçp¸
allegory	story about some other thingactsctsngersizationg wordsthatAöDÎçp¸
alleluia	words of being happy; Hallelujahctsngersizationg wordsthatAöDÎçp¸
allergic	have physical reactionHallelujahctsngersizationg wordsthatAöDÎçp¸
allergy	physical reactionctionHallelujahctsngersizationg wordsthatAöDÎçp¸
alleviate	make less troublingionHallelujahctsngersizationg wordsthatAöDÎçp¸
alley	side-streetroublingionHallelujahctsngersizationg wordsthatAöDÎçp¸
alliance	agreementetroublingionHallelujahctsngersizationg wordsthatAöDÎçp¸
allied	joined by agreementionHallelujahctsngersizationg wordsthatAöDÎçp¸
allies	joined in workementionHallelujahctsngersizationg wordsthatAöDÎçp¸
alliterate	make use of words with same lettersngersizationg wordsthatAöDÎçp¸
allocate	put on one sideds with same lettersngersizationg wordsthatAöDÎçp¸
allocated	put on one sideds with same lettersngersizationg wordsthatAöDÎçp¸
allocates	puts on one sides with same lettersngersizationg wordsthatAöDÎçp¸
allocating	putting on one sideith same lettersngersizationg wordsthatAöDÎçp¸
allocation	a thing or amount put to one sidersngersizationg wordsthatAöDÎçp¸
allocations	things or amounts put to one sidersngersizationg wordsthatAöDÎçp¸
allot	givegs or amounts put to one sidersngersizationg wordsthatAöDÎçp¸
allotment	distributionounts put to one sidersngersizationg wordsthatAöDÎçp¸
allow	lettributionounts put to one sidersngersizationg wordsthatAöDÎçp¸
allowable	that is let dones put to one sidersngersizationg wordsthatAöDÎçp¸
allowance	regular payment; not be hard in judging; [business]rdsthatAöDÎçp¸
allowances	regular payments; not be hard in judging; [business]dsthatAöDÎçp¸
allowed	letular payments; not be hard in judging; [business]dsthatAöDÎçp¸
allowing	letting payments; not be hard in judging; [business]dsthatAöDÎçp¸
allows	letsing payments; not be hard in judging; [business]dsthatAöDÎçp¸
alloy	mixed metal; mixednot be hard in judging; [business]dsthatAöDÎçp¸
allude	say something aboutot be hard in judging; [business]dsthatAöDÎçp¸
alluding	saying something aboutbe hard in judging; [business]dsthatAöDÎçp¸
allure	be pleasing tong aboutbe hard in judging; [business]dsthatAöDÎçp¸
allusion	something without detailshard in judging; [business]dsthatAöDÎçp¸
allusive	thing without detailsailshard in judging; [business]dsthatAöDÎçp¸
ally	supporter; be on the same sidein judging; [business]dsthatAöDÎçp¸
almanac	calendar with notese same sidein judging; [business]dsthatAöDÎçp¸
almighty	very great; the Father of Allein judging; [business]dsthatAöDÎçp¸
almond	a type of nuthe Father of Allein judging; [business]dsthatAöDÎçp¸
almost	almost of nuthe Father of Allein judging; [business]dsthatAöDÎçp¸
alms	money given to poorher of Allein judging; [business]dsthatAöDÎçp¸
aloft	high upiven to poorher of Allein judging; [business]dsthatAöDÎçp¸
alone	by oneselfn to poorher of Allein judging; [business]dsthatAöDÎçp¸
along	on; with; [second]rher of Allein judging; [business]dsthatAöDÎçp¸
alongside	near to, touching]rher of Allein judging; [business]dsthatAöDÎçp¸
aloof	at a distancehing]rher of Allein judging; [business]dsthatAöDÎçp¸
aloud	out loudtancehing]rher of Allein judging; [business]dsthatAöDÎçp¸
alp	high mountainhing]rher of Allein judging; [business]dsthatAöDÎçp¸
alpha	firstmountainhing]rher of Allein judging; [business]dsthatAöDÎçp¸
alphabet	the lettersinhing]rher of Allein judging; [business]dsthatAöDÎçp¸
alphabetic	of letters; ordered by lettersin judging; [business]dsthatAöDÎçp¸
alphabetical	by letters; ordered by lettersin judging; [business]dsthatAöDÎçp¸
alphameric	of letters and numbers lettersin judging; [business]dsthatAöDÎçp¸
alphanumeric	of letters and numbers lettersin judging; [business]dsthatAöDÎçp¸
already	up to now; beforembers lettersin judging; [business]dsthatAöDÎçp¸
alright	all right; beforembers lettersin judging; [business]dsthatAöDÎçp¸
also	in addition; [second]s lettersin judging; [business]dsthatAöDÎçp¸
altar	high table in church]s lettersin judging; [business]dsthatAöDÎçp¸
alter	make a change church]s lettersin judging; [business]dsthatAöDÎçp¸
alteration	a changehange church]s lettersin judging; [business]dsthatAöDÎçp¸
alterations	changesehange church]s lettersin judging; [business]dsthatAöDÎçp¸
altercation	violent argumenturch]s lettersin judging; [business]dsthatAöDÎçp¸
altered	made a changeenturch]s lettersin judging; [business]dsthatAöDÎçp¸
altering	making a changeturch]s lettersin judging; [business]dsthatAöDÎçp¸
alternate	do in turn; first one, then the othering; [business]dsthatAöDÎçp¸
alternative	thing which might take the place of another; different; [science]¸
alternatively	in a different way; [science]ace of another; different; [science]¸
alternatives	things which might take the place of another; [science] [science]¸
alters	makes a changeight take the place of another; [science] [science]¸
although	though; thongeight take the place of another; [science] [science]¸
altimeter	instrument for measuring higherce of another; [science] [science]¸
altitude	distance upfor measuring higherce of another; [science] [science]¸
altogether	completelypfor measuring higherce of another; [science] [science]¸
altruism	putting others firstring higherce of another; [science] [science]¸
alum	sort of salt used medicallygherce of another; [science] [science]¸
aluminium	aluminium; aluminum; [chemical]ce of another; [science] [science]¸
aluminiums	aluminiums; aluminums; [chemical] of another; [science] [science]¸
aluminum	aluminum; aluminium; [chemical]l] of another; [science] [science]¸
aluminums	aluminums; aluminiums; [chemical] of another; [science] [science]¸
alumnus	person who has been at some schoolof another; [science] [science]¸
always	at all times; [second] some schoolof another; [science] [science]¸
am	am all times; [second] some schoolof another; [science] [science]¸
amalgam	soft mixed substanced] some schoolof another; [science] [science]¸
amalgamate	get mixedd substanced] some schoolof another; [science] [science]¸
amalgamated	unitedxedd substanced] some schoolof another; [science] [science]¸
amalgams	mixed substancesanced] some schoolof another; [science] [science]¸
amanuensis	person writing down words for another for him [science] [science]¸
amaranth	ever-living flower; red-blue colorher for him [science] [science]¸
amaranths	ever-living flowers red-blue colorher for him [science] [science]¸
amass	get things together red-blue colorher for him [science] [science]¸
amassing	getting togetherher red-blue colorher for him [science] [science]¸
amateur	not doing for a livingd-blue colorher for him [science] [science]¸
amateurish	by untrained personingd-blue colorher for him [science] [science]¸
amaze	make very surprisedingd-blue colorher for him [science] [science]¸
amazed	made very surprisedingd-blue colorher for him [science] [science]¸
amazes	makes very surprisedngd-blue colorher for him [science] [science]¸
amazing	making very surprisedgd-blue colorher for him [science] [science]¸
amazingly	surprisinglysurprisedgd-blue colorher for him [science] [science]¸
ambassador	nation's representative in another countryhim [science] [science]¸
ambassadors	representativesentative in another countryhim [science] [science]¸
amber	clear, yellow substance used for ornamentyhim [science] [science]¸
ambidextrous	two-handed; able to use left and right hands equallyce] [science]¸
ambient	all round; on all sides left and right hands equallyce] [science]¸
ambiguities	with more than one possible senseright hands equallyce] [science]¸
ambiguity	with more than one possible senseright hands equallyce] [science]¸
ambiguous	not clear than one possible senseright hands equallyce] [science]¸
ambition	desire to go far; strong desire to do (a thing) well; [second]ce]¸
ambitions	desires; [second] strong desire to do (a thing) well; [second]ce]¸
ambitious	strongly desiring strong desire to do (a thing) well; [second]ce]¸
amble	slow, untroubled walkong desire to do (a thing) well; [second]ce]¸
ambulance	hospital automobilelkong desire to do (a thing) well; [second]ce]¸
ambulances	hospital automobileskong desire to do (a thing) well; [second]ce]¸
ambulatory	able to walk; able to be movede to do (a thing) well; [second]ce]¸
ambush	surprise attack; placing men in secret place for making surprise attack
ameliorate	make, become better; Let it be so!cret place for making surprise attack
amend	make better; put rightet it be so!cret place for making surprise attack
amended	changedtter; put rightet it be so!cret place for making surprise attack
amending	changingter; put rightet it be so!cret place for making surprise attack
amendment	changengter; put rightet it be so!cret place for making surprise attack
amends	to put right put rightet it be so!cret place for making surprise attack
amenities	comforts; pleasing qualities or things place for making surprise attack
amenity	comfort; pleasing quality or thingings place for making surprise attack
amerce	make (person) give payment; give punishment toor making surprise attack
america	Americaerson) give payment; give punishment toor making surprise attack
american	Americanrson) give payment; give punishment toor making surprise attack
americans	Americansson) give payment; give punishment toor making surprise attack
americas	Americassson) give payment; give punishment toor making surprise attack
amethyst	red-blue jewelgive payment; give punishment toor making surprise attack
amiable	kind; pleasing; with good feelingpunishment toor making surprise attack
amicable	as between friends; happy feelingpunishment toor making surprise attack
amid	amongtween friends; happy feelingpunishment toor making surprise attack
amidst	amongtween friends; happy feelingpunishment toor making surprise attack
amiss	wrongtween friends; happy feelingpunishment toor making surprise attack
amity	harmony; good relationppy feelingpunishment toor making surprise attack
ammeter	instrument for measuring electric currentnt toor making surprise attack
ammonia	ammoniaent for measuring electric currentnt toor making surprise attack
ammoniated	mixed with ammoniasuring electric currentnt toor making surprise attack
ammunition	firing material for guns electric currentnt toor making surprise attack
amnesia	loss of memoryl for guns electric currentnt toor making surprise attack
amnesty	overlooking of earlier crime (by government)toor making surprise attack
amoeba	most simple jelly-like animal(by government)toor making surprise attack
amok	going about with a violent desire (for blood)oor making surprise attack
among	among about with a violent desire (for blood)oor making surprise attack
amongst	among about with a violent desire (for blood)oor making surprise attack
amorous	loving; readily moved to lovesire (for blood)oor making surprise attack
amorously	lovinglyreadily moved to lovesire (for blood)oor making surprise attack
amorphic	without clear form; without organizationlood)oor making surprise attack
amorphous	without clear form; without organizationlood)oor making surprise attack
amount	amountt clear form; without organizationlood)oor making surprise attack
amounted	amountedclear form; without organizationlood)oor making surprise attack
amounting	amountinglear form; without organizationlood)oor making surprise attack
amounts	amountsnglear form; without organizationlood)oor making surprise attack
amour	a love-relation; metal cover used by armyood)oor making surprise attack
amp	unit of electric currentover used by armyood)oor making surprise attack
amperage	current (in amperes)rentover used by armyood)oor making surprise attack
ampere	unit of measure of electric currenty armyood)oor making surprise attack
ampersand	&, sign for 'and'f electric currenty armyood)oor making surprise attack
amphibian	animal living in water and on land; airplane landing on water or earth; great in amount
amphibious	able to move from water to landand; airplane landing on water or earth; great in amount
amphitheater	round building with stepped seats for public amusements; high seats forming half-circle in theater
amphitheaters	round buildings with stepped seats for public amusements; high seats forming half-circle in theaters
amphitheatre	round building with stepped seats for public amusements; high seats forming half-circle in theaterrs
ample	enough; with much spacepped seats for public amusements; high seats forming half-circle in theaterrs
amplifier	apparatus for making sound greaterfor public amusements; high seats forming half-circle in theaterrs
amplify	make greaterr making sound greaterfor public amusements; high seats forming half-circle in theaterrs
amplitude	size; being greating sound greaterfor public amusements; high seats forming half-circle in theaterrs
amply	quite enoughgreating sound greaterfor public amusements; high seats forming half-circle in theaterrs
amputate	cut offnoughgreating sound greaterfor public amusements; high seats forming half-circle in theaterrs
amputation	cutting offhgreating sound greaterfor public amusements; high seats forming half-circle in theaterrs
amuck	going about with a violent desire (for blood)amusements; high seats forming half-circle in theaterrs
amulet	ornament against bad powersdesire (for blood)amusements; high seats forming half-circle in theaterrs
amuse	give amusementst bad powersdesire (for blood)amusements; high seats forming half-circle in theaterrs
amused	gave, given amusementpowersdesire (for blood)amusements; high seats forming half-circle in theaterrs
amusement	amusementen amusementpowersdesire (for blood)amusements; high seats forming half-circle in theaterrs
amusements	amusementsn amusementpowersdesire (for blood)amusements; high seats forming half-circle in theaterrs
amuser	amuserentsn amusementpowersdesire (for blood)amusements; high seats forming half-circle in theaterrs
amusers	amusersntsn amusementpowersdesire (for blood)amusements; high seats forming half-circle in theaterrs
amuses	gives amusementsementpowersdesire (for blood)amusements; high seats forming half-circle in theaterrs
amusing	giving amusementementpowersdesire (for blood)amusements; high seats forming half-circle in theaterrs
amusingly	amusinglyusementementpowersdesire (for blood)amusements; high seats forming half-circle in theaterrs
an	anusinglyusementementpowersdesire (for blood)amusements; high seats forming half-circle in theaterrs
anachronism	old; out of tastementpowersdesire (for blood)amusements; high seats forming half-circle in theaterrs
anaconda	sort of great snakentpowersdesire (for blood)amusements; high seats forming half-circle in theaterrs
anaemia	poor condition of the blooddesire (for blood)amusements; high seats forming half-circle in theaterrs
anaesthesia	loss of feeling; unconscious condition blood)amusements; high seats forming half-circle in theaterrs
anaesthetic	thing producing loss of feeling, unconscious)amusements; high seats forming half-circle in theaterrs
anaesthetist	expert producing loss of feeling, unconsciousamusements; high seats forming half-circle in theaterrs
anaesthetize	make unconscious of pain feeling, unconsciousamusements; high seats forming half-circle in theaterrs
anagram	word formed from the letters of anothersciousamusements; high seats forming half-circle in theaterrs
anal	about opening where waste of body goes through; over orderlyh seats forming half-circle in theaterrs
analgesia	not feeling painere waste of body goes through; over orderlyh seats forming half-circle in theaterrs
analog	wave in form;  [computer] of body goes through; over orderlyh seats forming half-circle in theaterrs
analogous	parallel to, like in qualities; like in use or formr orderlyh seats forming half-circle in theaterrs
analogue	wave in form; [computer]lities; like in use or formr orderlyh seats forming half-circle in theaterrs
analogy	process of reasoning by parallelsike in use or formr orderlyh seats forming half-circle in theaterrs
analyse	get at the details of; get broken up (into simpler parts)rlyh seats forming half-circle in theaterrs
analysed	person, thing getting at the details of; got broken up (into simpler parts) half-circle in theaterrs
analyses	gets at the details of; gets broken up (into simpler parts)o simpler parts) half-circle in theaterrs
analysing	getting at detailss of; gets broken up (into simpler parts)o simpler parts) half-circle in theaterrs
analysis	process of getting details; statement of outcomepler parts)o simpler parts) half-circle in theaterrs
analyst	one getting detailsdetails; statement of outcomepler parts)o simpler parts) half-circle in theaterrs
analytic	given to getting detailsls; statement of outcomepler parts)o simpler parts) half-circle in theaterrs
analytical	given to getting detailsls; statement of outcomepler parts)o simpler parts) half-circle in theaterrs
analyze	get at the details of; get broken up (into simpler parts)s)o simpler parts) half-circle in theaterrs
analyzed	got at the details of; got broken up (into simpler parts)s)o simpler parts) half-circle in theaterrs
analyzer	got at the details of; got broken up (into simpler parts)s)o simpler parts) half-circle in theaterrs
analyzes	gets at the details of; gets broken up (into simpler parts)o simpler parts) half-circle in theaterrs
analyzing	getting at detailss of; gets broken up (into simpler parts)o simpler parts) half-circle in theaterrs
anarchy	condition in which there is no law or order; without governmentmpler parts) half-circle in theaterrs
anatomy	the structure of living bodies law or order; without governmentmpler parts) half-circle in theaterrs
ancestor	person in family lineng bodies law or order; without governmentmpler parts) half-circle in theaterrs
ancestors	persons in family lineg bodies law or order; without governmentmpler parts) half-circle in theaterrs
anchor	ship's hook; [second]eg bodies law or order; without governmentmpler parts) half-circle in theaterrs
anchored	fixed; [second]econd]eg bodies law or order; without governmentmpler parts) half-circle in theaterrs
anchoring	fixing; [second]cond]eg bodies law or order; without governmentmpler parts) half-circle in theaterrs
anchors	ship's hooks; [second]g bodies law or order; without governmentmpler parts) half-circle in theaterrs
ancient	oldp's hooks; [second]g bodies law or order; without governmentmpler parts) half-circle in theaterrs
and	andp's hooks; [second]g bodies law or order; without governmentmpler parts) half-circle in theaterrs
and/or	and/or hooks; [second]g bodies law or order; without governmentmpler parts) half-circle in theaterrs
andorra	Andorrahooks; [second]g bodies law or order; without governmentmpler parts) half-circle in theaterrs
anecdote	short storys; [second]g bodies law or order; without governmentmpler parts) half-circle in theaterrs
anecdotes	short stories [second]g bodies law or order; without governmentmpler parts) half-circle in theaterrs
anemia	having poor condition of the blood or order; without governmentmpler parts) half-circle in theaterrs
anemic	poor condition of the bloode blood or order; without governmentmpler parts) half-circle in theaterrs
anesthesia	loss of feeling; unconscious conditionorder; without governmentmpler parts) half-circle in theaterrs
anesthetic	thing producing loss of feeling, unconscious without governmentmpler parts) half-circle in theaterrs
anesthetics	things producing loss of feeling, unconsciouswithout governmentmpler parts) half-circle in theaterrs
angel	being with wings; [verse]feeling, unconsciouswithout governmentmpler parts) half-circle in theaterrs
angels	beings with wings; [verse]eeling, unconsciouswithout governmentmpler parts) half-circle in theaterrs
anger	violent feelingss; [verse]eeling, unconsciouswithout governmentmpler parts) half-circle in theaterrs
angered	caused violent feelingsse]eeling, unconsciouswithout governmentmpler parts) half-circle in theaterrs
angering	cause violent feelingssse]eeling, unconsciouswithout governmentmpler parts) half-circle in theaterrs
angers	cause violent feelingssse]eeling, unconsciouswithout governmentmpler parts) half-circle in theaterrs
angle	angle violent feelingssse]eeling, unconsciouswithout governmentmpler parts) half-circle in theaterrs
angled	angledviolent feelingssse]eeling, unconsciouswithout governmentmpler parts) half-circle in theaterrs
angles	anglesviolent feelingssse]eeling, unconsciouswithout governmentmpler parts) half-circle in theaterrs
angola	Angolaviolent feelingssse]eeling, unconsciouswithout governmentmpler parts) half-circle in theaterrs
angrily	angrilyiolent feelingssse]eeling, unconsciouswithout governmentmpler parts) half-circle in theaterrs
angry	angrylyiolent feelingssse]eeling, unconsciouswithout governmentmpler parts) half-circle in theaterrs
anguish	painylyiolent feelingssse]eeling, unconsciouswithout governmentmpler parts) half-circle in theaterrs
anguished	with painlent feelingssse]eeling, unconsciouswithout governmentmpler parts) half-circle in theaterrs
angular	having sharp anglesngssse]eeling, unconsciouswithout governmentmpler parts) half-circle in theaterrs
animal	animal sharp anglesngssse]eeling, unconsciouswithout governmentmpler parts) half-circle in theaterrs
animals	animalssharp anglesngssse]eeling, unconsciouswithout governmentmpler parts) half-circle in theaterrs
animated	bright; in motionesngssse]eeling, unconsciouswithout governmentmpler parts) half-circle in theaterrs
ankle	part joining leg to foot; [second]unconsciouswithout governmentmpler parts) half-circle in theaterrs
ankles	parts joining leg to foot; [second]nconsciouswithout governmentmpler parts) half-circle in theaterrs
anklet	anything put on round lower legond]nconsciouswithout governmentmpler parts) half-circle in theaterrs
annex	addition; make an additionr legond]nconsciouswithout governmentmpler parts) half-circle in theaterrs
annihilate	put to deathke an additionr legond]nconsciouswithout governmentmpler parts) half-circle in theaterrs
anniversary	one or more years after eventegond]nconsciouswithout governmentmpler parts) half-circle in theaterrs
announce	say; make publics after eventegond]nconsciouswithout governmentmpler parts) half-circle in theaterrs
announced	said; made public after eventegond]nconsciouswithout governmentmpler parts) half-circle in theaterrs
announcement	something said in publiceventegond]nconsciouswithout governmentmpler parts) half-circle in theaterrs
announcements	things said in publicliceventegond]nconsciouswithout governmentmpler parts) half-circle in theaterrs
announces	says; makes publiclicliceventegond]nconsciouswithout governmentmpler parts) half-circle in theaterrs
announcing	saying; making publicliceventegond]nconsciouswithout governmentmpler parts) half-circle in theaterrs
annoy	give troubleng publicliceventegond]nconsciouswithout governmentmpler parts) half-circle in theaterrs
annoyance	thing giving troublecliceventegond]nconsciouswithout governmentmpler parts) half-circle in theaterrs
annoyed	gave trouble; being of bad state of mindciouswithout governmentmpler parts) half-circle in theaterrs
annoying	giving troublebeing of bad state of mindciouswithout governmentmpler parts) half-circle in theaterrs
annoys	gives troubleebeing of bad state of mindciouswithout governmentmpler parts) half-circle in theaterrs
annual	every yearbleebeing of bad state of mindciouswithout governmentmpler parts) half-circle in theaterrs
annually	every yearbleebeing of bad state of mindciouswithout governmentmpler parts) half-circle in theaterrs
annuities	payments made every yearad state of mindciouswithout governmentmpler parts) half-circle in theaterrs
annuity	payment made every yearrad state of mindciouswithout governmentmpler parts) half-circle in theaterrs
anomalies	things not regular, not normal; seeming errorsithout governmentmpler parts) half-circle in theaterrs
anomaly	something not regular, not normal; seeming errorhout governmentmpler parts) half-circle in theaterrs
anonymous	without a name; name not givenmal; seeming errorhout governmentmpler parts) half-circle in theaterrs
anonymously	without nameme; name not givenmal; seeming errorhout governmentmpler parts) half-circle in theaterrs
anorak	sort of winter coate not givenmal; seeming errorhout governmentmpler parts) half-circle in theaterrs
anoraks	sorts of winter coat not givenmal; seeming errorhout governmentmpler parts) half-circle in theaterrs
another	anotherf winter coat not givenmal; seeming errorhout governmentmpler parts) half-circle in theaterrs
answer	answerrf winter coat not givenmal; seeming errorhout governmentmpler parts) half-circle in theaterrs
answerable	responsiblenter coat not givenmal; seeming errorhout governmentmpler parts) half-circle in theaterrs
answered	answeredblenter coat not givenmal; seeming errorhout governmentmpler parts) half-circle in theaterrs
answerer	answererblenter coat not givenmal; seeming errorhout governmentmpler parts) half-circle in theaterrs
answerers	answererslenter coat not givenmal; seeming errorhout governmentmpler parts) half-circle in theaterrs
answering	answeringlenter coat not givenmal; seeming errorhout governmentmpler parts) half-circle in theaterrs
answers	answersnglenter coat not givenmal; seeming errorhout governmentmpler parts) half-circle in theaterrs
ant	antwersnglenter coat not givenmal; seeming errorhout governmentmpler parts) half-circle in theaterrs
antagonism	feelings againstcoat not givenmal; seeming errorhout governmentmpler parts) half-circle in theaterrs
antagonize	attack; put another person against seeming errorhout governmentmpler parts) half-circle in theaterrs
antagonized	attacked; put another person againsteeming errorhout governmentmpler parts) half-circle in theaterrs
antagonizes	attacks; puts another person againsteeming errorhout governmentmpler parts) half-circle in theaterrs
antagonizing	attacking; putting another person againstg errorhout governmentmpler parts) half-circle in theaterrs
anthology	group of storiesng another person againstg errorhout governmentmpler parts) half-circle in theaterrs
anthracite	hard coalstoriesng another person againstg errorhout governmentmpler parts) half-circle in theaterrs
anti	againstalstoriesng another person againstg errorhout governmentmpler parts) half-circle in theaterrs
anti-	againstalstoriesng another person againstg errorhout governmentmpler parts) half-circle in theaterrs
anti-cyclone	good weatherriesng another person againstg errorhout governmentmpler parts) half-circle in theaterrs
anticipate	see what is coming another person againstg errorhout governmentmpler parts) half-circle in theaterrs
anticipated	saw what was cominganother person againstg errorhout governmentmpler parts) half-circle in theaterrs
anticipates	sees what is cominganother person againstg errorhout governmentmpler parts) half-circle in theaterrs
anticipating	taking necessary stepsther person againstg errorhout governmentmpler parts) half-circle in theaterrs
anticipation	feeling for coming eventsr person againstg errorhout governmentmpler parts) half-circle in theaterrs
antidote	something that works against poison; way of putting things right; anything that works against a wrong
antique	oldething that works against poison; way of putting things right; anything that works against a wrong
antiques	old thingsthat works against poison; way of putting things right; anything that works against a wrong
antiquity	the days of oldworks against poison; way of putting things right; anything that works against a wrong
antiseptic	keeping cleanldworks against poison; way of putting things right; anything that works against a wrong
antisocial	not given to groupss against poison; way of putting things right; anything that works against a wrong
ants	antsgiven to groupss against poison; way of putting things right; anything that works against a wrong
anvil	part on which metal is hammeredison; way of putting things right; anything that works against a wrong
anviled	made by hammeringal is hammeredison; way of putting things right; anything that works against a wrong
anviling	making by hammering is hammeredison; way of putting things right; anything that works against a wrong
anvils	parts on which metal is hammeredson; way of putting things right; anything that works against a wrong
anxious	troubled which metal is hammeredson; way of putting things right; anything that works against a wrong
any	anyubled which metal is hammeredson; way of putting things right; anything that works against a wrong
anybody	anybodyd which metal is hammeredson; way of putting things right; anything that works against a wrong
anyhow	anyhowyd which metal is hammeredson; way of putting things right; anything that works against a wrong
anyone	anyoneyd which metal is hammeredson; way of putting things right; anything that works against a wrong
anyplace	anyplace which metal is hammeredson; way of putting things right; anything that works against a wrong
anything	anything which metal is hammeredson; way of putting things right; anything that works against a wrong
anyway	anywayng which metal is hammeredson; way of putting things right; anything that works against a wrong
anywhere	anywhere which metal is hammeredson; way of putting things right; anything that works against a wrong
anzac	Anzacere which metal is hammeredson; way of putting things right; anything that works against a wrong
apache	Apachere which metal is hammeredson; way of putting things right; anything that works against a wrong
apart	not togetherch metal is hammeredson; way of putting things right; anything that works against a wrong
apartment	rooms in another's househammeredson; way of putting things right; anything that works against a wrong
apartments	rooms in another's househammeredson; way of putting things right; anything that works against a wrong
apathetic	without feeling; not interesteddson; way of putting things right; anything that works against a wrong
apathy	taking no interest in; not having feeling forutting things right; anything that works against a wrong
ape	monkey; copyingest in; not having feeling forutting things right; anything that works against a wrong
aperture	opening copyingest in; not having feeling forutting things right; anything that works against a wrong
apertures	openingscopyingest in; not having feeling forutting things right; anything that works against a wrong
apes	monkeysscopyingest in; not having feeling forutting things right; anything that works against a wrong
apiece	to every oneingest in; not having feeling forutting things right; anything that works against a wrong
apologies	statements of regretn; not having feeling forutting things right; anything that works against a wrong
apologise	make statement of regretot having feeling forutting things right; anything that works against a wrong
apologised	made statement of regretot having feeling forutting things right; anything that works against a wrong
apologises	makes statement of regrett having feeling forutting things right; anything that works against a wrong
apologising	making statement of regret having feeling forutting things right; anything that works against a wrong
apologize	make statement of regretet having feeling forutting things right; anything that works against a wrong
apologized	made statement of regretet having feeling forutting things right; anything that works against a wrong
apologizes	makes statement of regrett having feeling forutting things right; anything that works against a wrong
apologizing	making statement of regret having feeling forutting things right; anything that works against a wrong
apology	statement of regret regret having feeling forutting things right; anything that works against a wrong
apostrophe	mark for letters not there; word mark of ownertting things right; anything that works against a wrong
appal	shockfor letters not there; word mark of ownertting things right; anything that works against a wrong
appaled	shockedr letters not there; word mark of ownertting things right; anything that works against a wrong
appaling	shocking letters not there; word mark of ownertting things right; anything that works against a wrong
appall	shocking letters not there; word mark of ownertting things right; anything that works against a wrong
appalled	shockedg letters not there; word mark of ownertting things right; anything that works against a wrong
appalling	shocking letters not there; word mark of ownertting things right; anything that works against a wrong
appallingly	shockinglyetters not there; word mark of ownertting things right; anything that works against a wrong
appalls	shocksnglyetters not there; word mark of ownertting things right; anything that works against a wrong
appals	shocksnglyetters not there; word mark of ownertting things right; anything that works against a wrong
apparatus	apparatusyetters not there; word mark of ownertting things right; anything that works against a wrong
apparatuses	apparatusestters not there; word mark of ownertting things right; anything that works against a wrong
apparel	clothingsestters not there; word mark of ownertting things right; anything that works against a wrong
appareled	dressedgsestters not there; word mark of ownertting things right; anything that works against a wrong
appareling	making clothedrs not there; word mark of ownertting things right; anything that works against a wrong
apparels	clothinglothedrs not there; word mark of ownertting things right; anything that works against a wrong
apparent	clearinglothedrs not there; word mark of ownertting things right; anything that works against a wrong
apparently	seems clearhedrs not there; word mark of ownertting things right; anything that works against a wrong
apparition	strangely coming into view; word mark of ownertting things right; anything that works against a wrong
apparitions	things coming strangely into viewmark of ownertting things right; anything that works against a wrong
appeal	request; take question for decision; from lower to higher authority; have attraction forainst a wrong
appealed	requested; took question for decision; took from lower to higher authority; had attraction fora wrong
appealing	requesting; taking question for decision; taking from lower to higher authority; having attraction for
appeals	requests; takes question for authority; takes from lower to higher authority; has attraction foron for
appear	come into view; seemtion for authority; takes from lower to higher authority; has attraction foron for
appearance	look; seems to beeemtion for authority; takes from lower to higher authority; has attraction foron for
appearances	looks; seems to beemtion for authority; takes from lower to higher authority; has attraction foron for
appeared	came into view; seemedon for authority; takes from lower to higher authority; has attraction foron for
appearing	coming into view; seemingfor authority; takes from lower to higher authority; has attraction foron for
appears	comes into view; seemsingfor authority; takes from lower to higher authority; has attraction foron for
append	put on (to) at the endingfor authority; takes from lower to higher authority; has attraction foron for
appended	put on (to) at the endingfor authority; takes from lower to higher authority; has attraction foron for
appending	putting on (to) the endngfor authority; takes from lower to higher authority; has attraction foron for
appendix	addition at of book endngfor authority; takes from lower to higher authority; has attraction foron for
appends	puts on (to) at the endngfor authority; takes from lower to higher authority; has attraction foron for
appetite	desire for food the endngfor authority; takes from lower to higher authority; has attraction foron for
appetizer	something to give desire for foodority; takes from lower to higher authority; has attraction foron for
appetizers	things to give desire for foodoodority; takes from lower to higher authority; has attraction foron for
appetizing	giving desire for foodfor foodoodority; takes from lower to higher authority; has attraction foron for
applaud	give loud approvalfoodfor foodoodority; takes from lower to higher authority; has attraction foron for
applauded	gave loud approvalfoodfor foodoodority; takes from lower to higher authority; has attraction foron for
applauding	giving loud approvalodfor foodoodority; takes from lower to higher authority; has attraction foron for
applauds	gives loud approvallodfor foodoodority; takes from lower to higher authority; has attraction foron for
applause	loud approvalprovallodfor foodoodority; takes from lower to higher authority; has attraction foron for
apple	appleapprovalprovallodfor foodoodority; takes from lower to higher authority; has attraction foron for
apples	applespprovalprovallodfor foodoodority; takes from lower to higher authority; has attraction foron for
appliance	apparatusovalprovallodfor foodoodority; takes from lower to higher authority; has attraction foron for
appliances	instrumentsalprovallodfor foodoodority; takes from lower to higher authority; has attraction foron for
applicable	able to be usedovallodfor foodoodority; takes from lower to higher authority; has attraction foron for
applicant	person making requestdfor foodoodority; takes from lower to higher authority; has attraction foron for
applicants	persons making requestfor foodoodority; takes from lower to higher authority; has attraction foron for
application	attention to; letter to an authority; [science]rom lower to higher authority; has attraction foron for
applications	letters to an authority; things of use; [science]m lower to higher authority; has attraction foron for
applied	sent in name for; put to usengs of use; [science]m lower to higher authority; has attraction foron for
applies	sends in name for; puts to uses of use; [science]m lower to higher authority; has attraction foron for
apply	send in name for; put to useses of use; [science]m lower to higher authority; has attraction foron for
applying	sending in name for; putting to useuse; [science]m lower to higher authority; has attraction foron for
appoint	get (time, place) fixed; give (person) a position asower to higher authority; has attraction foron for
appointed	got (time, place) fixed; gave (person) a position as; having all necessary things attraction foron for
appointing	getting (time, place) fixed; giving (person) a position asng all necessary things attraction foron for
appointment	meeting; position givenixed; giving (person) a position asng all necessary things attraction foron for
appointments	meetings; positions givened; giving (person) a position asng all necessary things attraction foron for
appoints	gets (time, place) fixed; gives (person) a position asn asng all necessary things attraction foron for
appraisal	opinion of valuee) fixed; gives (person) a position asn asng all necessary things attraction foron for
appraise	put a price on; come to an opinionerson) a position asn asng all necessary things attraction foron for
appraised	put a price on; came to an opinionerson) a position asn asng all necessary things attraction foron for
appraises	puts a price on; comes to an opinionson) a position asn asng all necessary things attraction foron for
appraising	putting a price on; coming to an opinion a position asn asng all necessary things attraction foron for
appreciate	value; give high opinionng to an opinion a position asn asng all necessary things attraction foron for
appreciated	valued; gave high opiniong to an opinion a position asn asng all necessary things attraction foron for
appreciates	values; gives high opinion to an opinion a position asn asng all necessary things attraction foron for
appreciating	valuing; giving high opiniono an opinion a position asn asng all necessary things attraction foron for
appreciation	high opinion; increase in valuen opinion a position asn asng all necessary things attraction foron for
apprehension	fear opinion; increase in valuen opinion a position asn asng all necessary things attraction foron for
apprehensions	fearsopinion; increase in valuen opinion a position asn asng all necessary things attraction foron for
apprentice	learner; learner of a tradealuen opinion a position asn asng all necessary things attraction foron for
apprentices	learners of a trade a tradealuen opinion a position asn asng all necessary things attraction foron for
approach	way in; come, go near tradealuen opinion a position asn asng all necessary things attraction foron for
approached	came, gone nearo near tradealuen opinion a position asn asng all necessary things attraction foron for
approaches	ways in; comes, goes neardealuen opinion a position asn asng all necessary things attraction foron for
approaching	coming, going neares neardealuen opinion a position asn asng all necessary things attraction foron for
approbation	approvalgoing neares neardealuen opinion a position asn asng all necessary things attraction foron for
appropriate	take over; rightares neardealuen opinion a position asn asng all necessary things attraction foron for
appropriately	as rightr; rightares neardealuen opinion a position asn asng all necessary things attraction foron for
appropriating	takinghtr; rightares neardealuen opinion a position asn asng all necessary things attraction foron for
appropriation	given for; rightares neardealuen opinion a position asn asng all necessary things attraction foron for
approval	approvalr; rightares neardealuen opinion a position asn asng all necessary things attraction foron for
approvals	approvals; rightares neardealuen opinion a position asn asng all necessary things attraction foron for
approve	give approvalghtares neardealuen opinion a position asn asng all necessary things attraction foron for
approved	gave approvalghtares neardealuen opinion a position asn asng all necessary things attraction foron for
approver	ones giving approval neardealuen opinion a position asn asng all necessary things attraction foron for
approvers	one giving approvall neardealuen opinion a position asn asng all necessary things attraction foron for
approves	gives approvalrovall neardealuen opinion a position asn asng all necessary things attraction foron for
approving	approvingrovalrovall neardealuen opinion a position asn asng all necessary things attraction foron for
approximate	rough; get near toll neardealuen opinion a position asn asng all necessary things attraction foron for
approximately	roughly; near totoll neardealuen opinion a position asn asng all necessary things attraction foron for
approximating	making nearly likell neardealuen opinion a position asn asng all necessary things attraction foron for
approximation	making like; near to neardealuen opinion a position asn asng all necessary things attraction foron for
april	Aprilg like; near to neardealuen opinion a position asn asng all necessary things attraction foron for
apron	overalllike; near to neardealuen opinion a position asn asng all necessary things attraction foron for
aprons	overallsike; near to neardealuen opinion a position asn asng all necessary things attraction foron for
apt	rightllsike; near to neardealuen opinion a position asn asng all necessary things attraction foron for
aptly	rightlysike; near to neardealuen opinion a position asn asng all necessary things attraction foron for
arab	Arabtlysike; near to neardealuen opinion a position asn asng all necessary things attraction foron for
aramaic	Aramaicsike; near to neardealuen opinion a position asn asng all necessary things attraction foron for
arbitrarily	based only on opinionneardealuen opinion a position asn asng all necessary things attraction foron for
arbitrary	not based on rulesionneardealuen opinion a position asn asng all necessary things attraction foron for
arbitration	judginged on rulesionneardealuen opinion a position asn asng all necessary things attraction foron for
arbitrations	judgingsd on rulesionneardealuen opinion a position asn asng all necessary things attraction foron for
arbitrator	one who judgesulesionneardealuen opinion a position asn asng all necessary things attraction foron for
arbor	garden-house; walk with trees round iton a position asn asng all necessary things attraction foron for
arbores	garden-houses; walks with trees round it a position asn asng all necessary things attraction foron for
arbors	garden-houses; walks with trees round it a position asn asng all necessary things attraction foron for
arbour	garden-house; walk with trees round itit a position asn asng all necessary things attraction foron for
arc	part of line of a circle; bridge of light made by electric current; [science]ings attraction foron for
arcade	covered way; way with stores down the sidemade by electric current; [science]ings attraction foron for
arcane	secretd way; way with stores down the sidemade by electric current; [science]ings attraction foron for
arch	archetd way; way with stores down the sidemade by electric current; [science]ings attraction foron for
archaic	of very old times; no longer currente sidemade by electric current; [science]ings attraction foron for
arched	archedy old times; no longer currente sidemade by electric current; [science]ings attraction foron for
archeologist	expert in early times longer currente sidemade by electric current; [science]ings attraction foron for
archeology	science of early timeslonger currente sidemade by electric current; [science]ings attraction foron for
archer	archere of early timeslonger currente sidemade by electric current; [science]ings attraction foron for
archers	archers of early timeslonger currente sidemade by electric current; [science]ings attraction foron for
arches	archess of early timeslonger currente sidemade by electric current; [science]ings attraction foron for
arching	arching of early timeslonger currente sidemade by electric current; [science]ings attraction foron for
architect	designer of buildingsslonger currente sidemade by electric current; [science]ings attraction foron for
architects	designers of buildingslonger currente sidemade by electric current; [science]ings attraction foron for
architecture	design of buildings; art of structuressidemade by electric current; [science]ings attraction foron for
archive	keep; place to keep records; [computer]idemade by electric current; [science]ings attraction foron for
archived	kept; [computer]eep records; [computer]idemade by electric current; [science]ings attraction foron for
archiver	record keeper; [computer]ds; [computer]idemade by electric current; [science]ings attraction foron for
archives	records; make records; [computer]puter]idemade by electric current; [science]ings attraction foron for
archiving	keeping; make records; [computer]puter]idemade by electric current; [science]ings attraction foron for
arcs	parts of line of a circle; bridges of light made by electric current; [science]gs attraction foron for
ardor	warm feeling, desire; burning heat of light made by electric current; [science]gs attraction foron for
ardors	warm feelings, desires; burning heatf light made by electric current; [science]gs attraction foron for
ardour	warm feeling, desire; burning heatatf light made by electric current; [science]gs attraction foron for
arduous	hard feeling, desire; burning heatatf light made by electric current; [science]gs attraction foron for
arduously	full with hard worke; burning heatatf light made by electric current; [science]gs attraction foron for
are	arel with hard worke; burning heatatf light made by electric current; [science]gs attraction foron for
area	space; square measure; land; [science]light made by electric current; [science]gs attraction foron for
areas	spaces; fields; lands; [science]ience]light made by electric current; [science]gs attraction foron for
arena	ringes; fields; lands; [science]ience]light made by electric current; [science]gs attraction foron for
arenas	sporting rings; lands; [science]ience]light made by electric current; [science]gs attraction foron for
argentina	Argentinarings; lands; [science]ience]light made by electric current; [science]gs attraction foron for
argon	argon; chemical Ar; [chemistry]]ience]light made by electric current; [science]gs attraction foron for
argot	words used by a special groupy]]ience]light made by electric current; [science]gs attraction foron for
arguable	able to make an argumentgroupy]]ience]light made by electric current; [science]gs attraction foron for
arguably	able to make an argumentgroupy]]ience]light made by electric current; [science]gs attraction foron for
argue	make argumentan argumentgroupy]]ience]light made by electric current; [science]gs attraction foron for
argued	making argument argumentgroupy]]ience]light made by electric current; [science]gs attraction foron for
argues	makes argumentt argumentgroupy]]ience]light made by electric current; [science]gs attraction foron for
arguing	made argumenttt argumentgroupy]]ience]light made by electric current; [science]gs attraction foron for
argument	argumentumenttt argumentgroupy]]ience]light made by electric current; [science]gs attraction foron for
arguments	argumentsmenttt argumentgroupy]]ience]light made by electric current; [science]gs attraction foron for
arise	gets uptsmenttt argumentgroupy]]ience]light made by electric current; [science]gs attraction foron for
arisen	gotten upmenttt argumentgroupy]]ience]light made by electric current; [science]gs attraction foron for
arises	get up upmenttt argumentgroupy]]ience]light made by electric current; [science]gs attraction foron for
arising	getting upenttt argumentgroupy]]ience]light made by electric current; [science]gs attraction foron for
aristocracy	high societyttt argumentgroupy]]ience]light made by electric current; [science]gs attraction foron for
arithmetic	arithmetictyttt argumentgroupy]]ience]light made by electric current; [science]gs attraction foron for
arithmetically	with arithmetic argumentgroupy]]ience]light made by electric current; [science]gs attraction foron for
arizona	Arizonaithmetic argumentgroupy]]ience]light made by electric current; [science]gs attraction foron for
ark	Noah's shipetic argumentgroupy]]ience]light made by electric current; [science]gs attraction foron for
arkansas	Arkansashipetic argumentgroupy]]ience]light made by electric current; [science]gs attraction foron for
arm	armansashipetic argumentgroupy]]ience]light made by electric current; [science]gs attraction foron for
armed	armedsashipetic argumentgroupy]]ience]light made by electric current; [science]gs attraction foron for
armies	armiesashipetic argumentgroupy]]ience]light made by electric current; [science]gs attraction foron for
arming	armingashipetic argumentgroupy]]ience]light made by electric current; [science]gs attraction foron for
armor	metal cover used by armygroupy]]ience]light made by electric current; [science]gs attraction foron for
armored	metal cover used by armygroupy]]ience]light made by electric current; [science]gs attraction foron for
armories	houses for arms. by armygroupy]]ience]light made by electric current; [science]gs attraction foron for
armoring	putting metal cover armygroupy]]ience]light made by electric current; [science]gs attraction foron for
armors	metal covers used by armyroupy]]ience]light made by electric current; [science]gs attraction foron for
armory	house for armssed by armyroupy]]ience]light made by electric current; [science]gs attraction foron for
armpit	hollow under the arm armyroupy]]ience]light made by electric current; [science]gs attraction foron for
arms	armsow under the arm armyroupy]]ience]light made by electric current; [science]gs attraction foron for
army	armyow under the arm armyroupy]]ience]light made by electric current; [science]gs attraction foron for
arose	got up under the arm armyroupy]]ience]light made by electric current; [science]gs attraction foron for
around	round; about the arm armyroupy]]ience]light made by electric current; [science]gs attraction foron for
arouse	get awakeout the arm armyroupy]]ience]light made by electric current; [science]gs attraction foron for
arrange	put in order the arm armyroupy]]ience]light made by electric current; [science]gs attraction foron for
arranged	put in order the arm armyroupy]]ience]light made by electric current; [science]gs attraction foron for
arrangement	agreement; [science, second]py]]ience]light made by electric current; [science]gs attraction foron for
arrangements	agreements; [science, second]y]]ience]light made by electric current; [science]gs attraction foron for
arranges	puts in orderscience, second]y]]ience]light made by electric current; [science]gs attraction foron for
arranging	putting in orderence, second]y]]ience]light made by electric current; [science]gs attraction foron for
array	orderng in orderence, second]y]]ience]light made by electric current; [science]gs attraction foron for
arrays	order linesorderence, second]y]]ience]light made by electric current; [science]gs attraction foron for
arrears	late paymentrderence, second]y]]ience]light made by electric current; [science]gs attraction foron for
arrest	put under police control; grip; stope]light made by electric current; [science]gs attraction foron for
arrested	put under police control; be gripped; be stopped by electric current; [science]gs attraction foron for
arresting	gripping; stoppingontrol; be gripped; be stopped by electric current; [science]gs attraction foron for
arrests	put under police control; be gripped; be stopped by electric current; [science]gs attraction foron for
arrival	person/thing getting inl; be gripped; be stopped by electric current; [science]gs attraction foron for
arrivals	persons/things getting in be gripped; be stopped by electric current; [science]gs attraction foron for
arrive	get tos/things getting in be gripped; be stopped by electric current; [science]gs attraction foron for
arrived	got to place; cameting in be gripped; be stopped by electric current; [science]gs attraction foron for
arrives	gets to, here; comesng in be gripped; be stopped by electric current; [science]gs attraction foron for
arriving	getting to; comingesng in be gripped; be stopped by electric current; [science]gs attraction foron for
arrogance	acting as if others are unimportantd; be stopped by electric current; [science]gs attraction foron for
arrogant	acting as if others are unimportantd; be stopped by electric current; [science]gs attraction foron for
arrow	pointed stick; [verse]e unimportantd; be stopped by electric current; [science]gs attraction foron for
arrows	pointers; sticks with points; [verse] be stopped by electric current; [science]gs attraction foron for
arse	foolish person; seat of a person; long-eared animal of horse familyt; [science]gs attraction foron for
arsenal	military store; seat of a person; long-eared animal of horse familyt; [science]gs attraction foron for
arsenals	military stores seat of a person; long-eared animal of horse familyt; [science]gs attraction foron for
art	art; falsetores seat of a person; long-eared animal of horse familyt; [science]gs attraction foron for
artful	full of trickss seat of a person; long-eared animal of horse familyt; [science]gs attraction foron for
article	thing; story; a, an, thea person; long-eared animal of horse familyt; [science]gs attraction foron for
articles	things; stories; a, an, theerson; long-eared animal of horse familyt; [science]gs attraction foron for
artificial	produced by art; not naturalrson; long-eared animal of horse familyt; [science]gs attraction foron for
artificially	falsely; not naturallyaturalrson; long-eared animal of horse familyt; [science]gs attraction foron for
artillery	great guns; field gunsaturalrson; long-eared animal of horse familyt; [science]gs attraction foron for
artist	painteruns; field gunsaturalrson; long-eared animal of horse familyt; [science]gs attraction foron for
artistic	able at art field gunsaturalrson; long-eared animal of horse familyt; [science]gs attraction foron for
artists	paintersart field gunsaturalrson; long-eared animal of horse familyt; [science]gs attraction foron for
artless	simplersart field gunsaturalrson; long-eared animal of horse familyt; [science]gs attraction foron for
arts	artslersart field gunsaturalrson; long-eared animal of horse familyt; [science]gs attraction foron for
artwork	work of art field gunsaturalrson; long-eared animal of horse familyt; [science]gs attraction foron for
artworks	works of artfield gunsaturalrson; long-eared animal of horse familyt; [science]gs attraction foron for
as	asrks of artfield gunsaturalrson; long-eared animal of horse familyt; [science]gs attraction foron for
asbestos	asbestos artfield gunsaturalrson; long-eared animal of horse familyt; [science]gs attraction foron for
ascend	go uptos artfield gunsaturalrson; long-eared animal of horse familyt; [science]gs attraction foron for
ascended	gone ups artfield gunsaturalrson; long-eared animal of horse familyt; [science]gs attraction foron for
ascending	going up artfield gunsaturalrson; long-eared animal of horse familyt; [science]gs attraction foron for
ascends	goes upp artfield gunsaturalrson; long-eared animal of horse familyt; [science]gs attraction foron for
ascertain	make certainfield gunsaturalrson; long-eared animal of horse familyt; [science]gs attraction foron for
ascertaining	making certaineld gunsaturalrson; long-eared animal of horse familyt; [science]gs attraction foron for
ascetic	one not giving way to desires; not taking normal pleasuresse familyt; [science]gs attraction foron for
asceticism	not giving way to desires; not taking normal pleasuresuresse familyt; [science]gs attraction foron for
ascetics	persons not giving way to desires; not taking normal pleasuresamilyt; [science]gs attraction foron for
ash	powder from material after burning; sort of shade tree; [science, second]ience]gs attraction foron for
ashamed	feeling of shamerial after burning; sort of shade tree; [science, second]ience]gs attraction foron for
ashcan	waste box; dust box; waste vesselg; sort of shade tree; [science, second]ience]gs attraction foron for
ashes	powder from burned materials; [science, second]de tree; [science, second]ience]gs attraction foron for
ashore	on landfrom burned materials; [science, second]de tree; [science, second]ience]gs attraction foron for
aside	on one side burned materials; [science, second]de tree; [science, second]ience]gs attraction foron for
ask	make a request; put a question[science, second]de tree; [science, second]ience]gs attraction foron for
asked	made a request; put a question[science, second]de tree; [science, second]ience]gs attraction foron for
asking	making a request; putting a questionce, second]de tree; [science, second]ience]gs attraction foron for
asks	makes a request; puts a questiontionce, second]de tree; [science, second]ience]gs attraction foron for
asleep	sleepingrequest; puts a questiontionce, second]de tree; [science, second]ience]gs attraction foron for
aspect	point of viewst; puts a questiontionce, second]de tree; [science, second]ience]gs attraction foron for
aspects	points of viewt; puts a questiontionce, second]de tree; [science, second]ience]gs attraction foron for
aspersion	attack on good namets a questiontionce, second]de tree; [science, second]ience]gs attraction foron for
aspiration	hopeck on good namets a questiontionce, second]de tree; [science, second]ience]gs attraction foron for
aspirations	hopesk on good namets a questiontionce, second]de tree; [science, second]ience]gs attraction foron for
ass	long-eared animal of horse family; foolish person; seat of a personecond]ience]gs attraction foron for
assassin	one who puts to deathhorse family; foolish person; seat of a personecond]ience]gs attraction foron for
assassinate	put to death to deathhorse family; foolish person; seat of a personecond]ience]gs attraction foron for
assassination	death by a violent attacke family; foolish person; seat of a personecond]ience]gs attraction foron for
assassinations	deaths by a violent attack family; foolish person; seat of a personecond]ience]gs attraction foron for
assault	attack by a violent attack family; foolish person; seat of a personecond]ience]gs attraction foron for
assaulted	attackedy a violent attack family; foolish person; seat of a personecond]ience]gs attraction foron for
assaulting	attacking a violent attack family; foolish person; seat of a personecond]ience]gs attraction foron for
assaults	attacksng a violent attack family; foolish person; seat of a personecond]ience]gs attraction foron for
assemble	come togetheriolent attack family; foolish person; seat of a personecond]ience]gs attraction foron for
assembled	came togetheriolent attack family; foolish person; seat of a personecond]ience]gs attraction foron for
assembler	low level programming languageily; foolish person; seat of a personecond]ience]gs attraction foron for
assembles	comes togetherramming languageily; foolish person; seat of a personecond]ience]gs attraction foron for
assemblies	meetingsgetherramming languageily; foolish person; seat of a personecond]ience]gs attraction foron for
assembling	getting togethermming languageily; foolish person; seat of a personecond]ience]gs attraction foron for
assembly	meeting togethermming languageily; foolish person; seat of a personecond]ience]gs attraction foron for
assent	agreementogethermming languageily; foolish person; seat of a personecond]ience]gs attraction foron for
assert	put forward; say that (a thing) is soolish person; seat of a personecond]ience]gs attraction foron for
asserted	put forward; said that (a thing) is solish person; seat of a personecond]ience]gs attraction foron for
asserting	putting forward; saying that (a thing) is soerson; seat of a personecond]ience]gs attraction foron for
assertion	(idea) put forward; statement(a thing) is soerson; seat of a personecond]ience]gs attraction foron for
assertive	given to strong statementment(a thing) is soerson; seat of a personecond]ience]gs attraction foron for
asserts	puts forward; says that (a thing) is sois soerson; seat of a personecond]ience]gs attraction foron for
asses	long-eared animals of horse family; foolish persons; seat of a personsnd]ience]gs attraction foron for
assess	put a value onmals of horse family; foolish persons; seat of a personsnd]ience]gs attraction foron for
assessed	value put ononmals of horse family; foolish persons; seat of a personsnd]ience]gs attraction foron for
assesses	puts value onnmals of horse family; foolish persons; seat of a personsnd]ience]gs attraction foron for
assessing	valuinglue onnmals of horse family; foolish persons; seat of a personsnd]ience]gs attraction foron for
assessment	value; tax onnmals of horse family; foolish persons; seat of a personsnd]ience]gs attraction foron for
assessments	values; taxesnmals of horse family; foolish persons; seat of a personsnd]ience]gs attraction foron for
assessor	one who puts value on horse family; foolish persons; seat of a personsnd]ience]gs attraction foron for
asset	property; [business]n horse family; foolish persons; seat of a personsnd]ience]gs attraction foron for
assets	properties; [business]horse family; foolish persons; seat of a personsnd]ience]gs attraction foron for
assign	give toies; [business]horse family; foolish persons; seat of a personsnd]ience]gs attraction foron for
assignation	private meetingsiness]horse family; foolish persons; seat of a personsnd]ience]gs attraction foron for
assigned	given tomeetingsiness]horse family; foolish persons; seat of a personsnd]ience]gs attraction foron for
assigning	giving toeetingsiness]horse family; foolish persons; seat of a personsnd]ience]gs attraction foron for
assignment	giving; given undertakingse family; foolish persons; seat of a personsnd]ience]gs attraction foron for
assignments	given undertakingertakingse family; foolish persons; seat of a personsnd]ience]gs attraction foron for
assigns	gives todertakingertakingse family; foolish persons; seat of a personsnd]ience]gs attraction foron for
assist	give helpertakingertakingse family; foolish persons; seat of a personsnd]ience]gs attraction foron for
assistance	help helpertakingertakingse family; foolish persons; seat of a personsnd]ience]gs attraction foron for
assistant	person working for anothere family; foolish persons; seat of a personsnd]ience]gs attraction foron for
assisted	given helpking for anothere family; foolish persons; seat of a personsnd]ience]gs attraction foron for
assisting	giving helping for anothere family; foolish persons; seat of a personsnd]ience]gs attraction foron for
assists	gives helpping for anothere family; foolish persons; seat of a personsnd]ience]gs attraction foron for
associate	person working with another; get togethersh persons; seat of a personsnd]ience]gs attraction foron for
associated	connectedrking with another; get togethersh persons; seat of a personsnd]ience]gs attraction foron for
associates	persons working with another get togethersh persons; seat of a personsnd]ience]gs attraction foron for
associating	getting togetherwith another get togethersh persons; seat of a personsnd]ience]gs attraction foron for
association	organization; connection of ideas; [social] persons; seat of a personsnd]ience]gs attraction foron for
associations	organizations; connections of ideas; [social]ersons; seat of a personsnd]ience]gs attraction foron for
assort	put into groups, sortsions of ideas; [social]ersons; seat of a personsnd]ience]gs attraction foron for
assorted	mixed, of different sortss of ideas; [social]ersons; seat of a personsnd]ience]gs attraction foron for
assorting	putting into groups, sorts of ideas; [social]ersons; seat of a personsnd]ience]gs attraction foron for
assortment	mixed selectionoups, sorts of ideas; [social]ersons; seat of a personsnd]ience]gs attraction foron for
assortments	mixed selectionsups, sorts of ideas; [social]ersons; seat of a personsnd]ience]gs attraction foron for
assorts	puts into groups, sortsrts of ideas; [social]ersons; seat of a personsnd]ience]gs attraction foron for
assume	take to be trues, sortsrts of ideas; [social]ersons; seat of a personsnd]ience]gs attraction foron for
assumed	taken to be true, sortsrts of ideas; [social]ersons; seat of a personsnd]ience]gs attraction foron for
assumes	takes to be true, sortsrts of ideas; [social]ersons; seat of a personsnd]ience]gs attraction foron for
assuming	taking to be true sortsrts of ideas; [social]ersons; seat of a personsnd]ience]gs attraction foron for
assumption	thing taken as certainsrts of ideas; [social]ersons; seat of a personsnd]ience]gs attraction foron for
assumptions	things taken as certainrts of ideas; [social]ersons; seat of a personsnd]ience]gs attraction foron for
assurance	feeling certain certainrts of ideas; [social]ersons; seat of a personsnd]ience]gs attraction foron for
assure	say without any doubtinrts of ideas; [social]ersons; seat of a personsnd]ience]gs attraction foron for
assured	said without doubtubtinrts of ideas; [social]ersons; seat of a personsnd]ience]gs attraction foron for
assures	says without any doubtnrts of ideas; [social]ersons; seat of a personsnd]ience]gs attraction foron for
assuring	making certainny doubtnrts of ideas; [social]ersons; seat of a personsnd]ience]gs attraction foron for
asterisk	printer's starny doubtnrts of ideas; [social]ersons; seat of a personsnd]ience]gs attraction foron for
asterisks	printer's starsy doubtnrts of ideas; [social]ersons; seat of a personsnd]ience]gs attraction foron for
astonish	give surprisersy doubtnrts of ideas; [social]ersons; seat of a personsnd]ience]gs attraction foron for
astonished	given surprisesy doubtnrts of ideas; [social]ersons; seat of a personsnd]ience]gs attraction foron for
astonishing	surprisingrisesy doubtnrts of ideas; [social]ersons; seat of a personsnd]ience]gs attraction foron for
astray	wrongisingrisesy doubtnrts of ideas; [social]ersons; seat of a personsnd]ience]gs attraction foron for
astronaut	astronautgrisesy doubtnrts of ideas; [social]ersons; seat of a personsnd]ience]gs attraction foron for
astronomer	one who observes starsnrts of ideas; [social]ersons; seat of a personsnd]ience]gs attraction foron for
astronomers	persons who observe starss of ideas; [social]ersons; seat of a personsnd]ience]gs attraction foron for
astronomy	science of the starsstarss of ideas; [social]ersons; seat of a personsnd]ience]gs attraction foron for
astute	sharpce of the starsstarss of ideas; [social]ersons; seat of a personsnd]ience]gs attraction foron for
astutely	sharply of the starsstarss of ideas; [social]ersons; seat of a personsnd]ience]gs attraction foron for
asylum	place where one is in safe keepings; [social]ersons; seat of a personsnd]ience]gs attraction foron for
asynchronous	not taking place at the same timegs; [social]ersons; seat of a personsnd]ience]gs attraction foron for
at	att taking place at the same timegs; [social]ersons; seat of a personsnd]ience]gs attraction foron for
ate	took foodg place at the same timegs; [social]ersons; seat of a personsnd]ience]gs attraction foron for
atest	test word without number suffixmegs; [social]ersons; seat of a personsnd]ience]gs attraction foron for
atest1	trailing semicolons; ; ; suffixmegs; [social]ersons; seat of a personsnd]ience]gs attraction foron for
atest2	embedded semicolons; look for; ; ; second definition seat of a personsnd]ience]gs attraction foron for
atest3	singel quotes round word; 'single quotes' definition seat of a personsnd]ience]gs attraction foron for
atest4	double quotes round word; "double quotes" definition seat of a personsnd]ience]gs attraction foron for
atest5	::parts of speech features; [n.] in word fieldnition seat of a personsnd]ience]gs attraction foron for
atest6	embedded square bracket in definition; [second]ition seat of a personsnd]ience]gs attraction foron for
atest7	:: i. in bracket of word; see ahhtion; [second]ition seat of a personsnd]ience]gs attraction foron for
atest8	:: i. plus square bracket interjection in definitions; [INTERJECTION] surprise; pleasuretion foron for
atest9	commas in definition; here, be, commas; did it work?s; [INTERJECTION] surprise; pleasuretion foron for
atheism	belief there is no higher power commas; did it work?s; [INTERJECTION] surprise; pleasuretion foron for
atheist	one with belief there is no higher powerdid it work?s; [INTERJECTION] surprise; pleasuretion foron for
atheists	persons with belief there is no higher powerit work?s; [INTERJECTION] surprise; pleasuretion foron for
athlete	expert at sportlief there is no higher powerit work?s; [INTERJECTION] surprise; pleasuretion foron for
athletics	sports at sportlief there is no higher powerit work?s; [INTERJECTION] surprise; pleasuretion foron for
atlas	map-bookt sportlief there is no higher powerit work?s; [INTERJECTION] surprise; pleasuretion foron for
atlases	map-books sportlief there is no higher powerit work?s; [INTERJECTION] surprise; pleasuretion foron for
atmosphere	air-books sportlief there is no higher powerit work?s; [INTERJECTION] surprise; pleasuretion foron for
atmospheric	of (in) the airlief there is no higher powerit work?s; [INTERJECTION] surprise; pleasuretion foron for
atom	smallest unit; very small bitno higher powerit work?s; [INTERJECTION] surprise; pleasuretion foron for
atomic	of, being, like the smallest unitigher powerit work?s; [INTERJECTION] surprise; pleasuretion foron for
atoms	smallest units; very small bitsitigher powerit work?s; [INTERJECTION] surprise; pleasuretion foron for
atrocious	shocking; disgusting small bitsitigher powerit work?s; [INTERJECTION] surprise; pleasuretion foron for
atrociously	shockingly; disgustinglyll bitsitigher powerit work?s; [INTERJECTION] surprise; pleasuretion foron for
atrocities	shocking things; disgusting thingsgher powerit work?s; [INTERJECTION] surprise; pleasuretion foron for
atrocity	something shocking; something disgustingowerit work?s; [INTERJECTION] surprise; pleasuretion foron for
attach	make a join; make part of an emailustingowerit work?s; [INTERJECTION] surprise; pleasuretion foron for
attach\E9	persons of government in another countryowerit work?s; [INTERJECTION] surprise; pleasuretion foron for
attach\E9s	person of government in another countryyowerit work?s; [INTERJECTION] surprise; pleasuretion foron for
attached	having love for; part of an email; made joined work?s; [INTERJECTION] surprise; pleasuretion foron for
attaches	makes a join; makes part of an emailade joined work?s; [INTERJECTION] surprise; pleasuretion foron for
attaching	joining join; makes part of an emailade joined work?s; [INTERJECTION] surprise; pleasuretion foron for
attachment	feeling for; thing made a part of an emailined work?s; [INTERJECTION] surprise; pleasuretion foron for
attachments	feelings for; things made a part of an emailed work?s; [INTERJECTION] surprise; pleasuretion foron for
attack	attackgs for; things made a part of an emailed work?s; [INTERJECTION] surprise; pleasuretion foron for
attacked	attacked for; things made a part of an emailed work?s; [INTERJECTION] surprise; pleasuretion foron for
attacker	attacker for; things made a part of an emailed work?s; [INTERJECTION] surprise; pleasuretion foron for
attackers	attackersfor; things made a part of an emailed work?s; [INTERJECTION] surprise; pleasuretion foron for
attacking	attackingfor; things made a part of an emailed work?s; [INTERJECTION] surprise; pleasuretion foron for
attacks	attacksngfor; things made a part of an emailed work?s; [INTERJECTION] surprise; pleasuretion foron for
attain	get, come to; things made a part of an emailed work?s; [INTERJECTION] surprise; pleasuretion foron for
attainment	power of doing what one has come by an emailed work?s; [INTERJECTION] surprise; pleasuretion foron for
attempt	attemptf doing what one has come by an emailed work?s; [INTERJECTION] surprise; pleasuretion foron for
attempted	attempteddoing what one has come by an emailed work?s; [INTERJECTION] surprise; pleasuretion foron for
attempter	attempterdoing what one has come by an emailed work?s; [INTERJECTION] surprise; pleasuretion foron for
attempting	attemptingoing what one has come by an emailed work?s; [INTERJECTION] surprise; pleasuretion foron for
attempts	attemptsngoing what one has come by an emailed work?s; [INTERJECTION] surprise; pleasuretion foron for
attend	give attention toat one has come by an emailed work?s; [INTERJECTION] surprise; pleasuretion foron for
attendance	waiting, being present at; body of persons presentk?s; [INTERJECTION] surprise; pleasuretion foron for
attendant	being present, coming with; waiting (on); servanttk?s; [INTERJECTION] surprise; pleasuretion foron for
attended	gave attention coming with; waiting (on); servanttk?s; [INTERJECTION] surprise; pleasuretion foron for
attending	giving attentionoming with; waiting (on); servanttk?s; [INTERJECTION] surprise; pleasuretion foron for
attends	gives attentionnoming with; waiting (on); servanttk?s; [INTERJECTION] surprise; pleasuretion foron for
attention	attentionentionnoming with; waiting (on); servanttk?s; [INTERJECTION] surprise; pleasuretion foron for
attentions	attentionsntionnoming with; waiting (on); servanttk?s; [INTERJECTION] surprise; pleasuretion foron for
attest	make a statementoming with; waiting (on); servanttk?s; [INTERJECTION] surprise; pleasuretion foron for
attesting	making a statement against; waiting (on); servanttk?s; [INTERJECTION] surprise; pleasuretion foron for
attic	room at top of housegainst; waiting (on); servanttk?s; [INTERJECTION] surprise; pleasuretion foron for
attics	rooms at top of housesinst; waiting (on); servanttk?s; [INTERJECTION] surprise; pleasuretion foron for
attire	dress at top of housesinst; waiting (on); servanttk?s; [INTERJECTION] surprise; pleasuretion foron for
attired	dressedt top of housesinst; waiting (on); servanttk?s; [INTERJECTION] surprise; pleasuretion foron for
attitude	behavior; [social]usesinst; waiting (on); servanttk?s; [INTERJECTION] surprise; pleasuretion foron for
attitudes	behaviors; [social]sesinst; waiting (on); servanttk?s; [INTERJECTION] surprise; pleasuretion foron for
attorney	representatives in law; authority as representative?s; [INTERJECTION] surprise; pleasuretion foron for
attorneys	representative in law; authorities as representatives; [INTERJECTION] surprise; pleasuretion foron for
attract	have, get attentionaw; authorities as representatives; [INTERJECTION] surprise; pleasuretion foron for
attracted	had attention; get attractionities as representatives; [INTERJECTION] surprise; pleasuretion foron for
attracting	pulling to selfget attractionities as representatives; [INTERJECTION] surprise; pleasuretion foron for
attraction	attraction selfget attractionities as representatives; [INTERJECTION] surprise; pleasuretion foron for
attractions	attractionsselfget attractionities as representatives; [INTERJECTION] surprise; pleasuretion foron for
attractive	pleasing; good lookingractionities as representatives; [INTERJECTION] surprise; pleasuretion foron for
attracts	has, gets attentioningractionities as representatives; [INTERJECTION] surprise; pleasuretion foron for
attribute	property; put down togractionities as representatives; [INTERJECTION] surprise; pleasuretion foron for
attributed	givenrty; put down togractionities as representatives; [INTERJECTION] surprise; pleasuretion foron for
attributes	propertiesput down togractionities as representatives; [INTERJECTION] surprise; pleasuretion foron for
attributing	givingtiesput down togractionities as representatives; [INTERJECTION] surprise; pleasuretion foron for
auction	put up for offersn togractionities as representatives; [INTERJECTION] surprise; pleasuretion foron for
auctions	put up for offersn togractionities as representatives; [INTERJECTION] surprise; pleasuretion foron for
audacious	without fear, taking great chances; without shameives; [INTERJECTION] surprise; pleasuretion foron for
audible	able to be heardking great chances; without shameives; [INTERJECTION] surprise; pleasuretion foron for
audience	persons at heardking great chances; without shameives; [INTERJECTION] surprise; pleasuretion foron for
audiences	persons at heardking great chances; without shameives; [INTERJECTION] surprise; pleasuretion foron for
audio	soundns at heardking great chances; without shameives; [INTERJECTION] surprise; pleasuretion foron for
audit	looking over of accounts by expert; without shameives; [INTERJECTION] surprise; pleasuretion foron for
audited	accounts looked overunts by expert; without shameives; [INTERJECTION] surprise; pleasuretion foron for
auditing	looking over of accounts by expert; without shameives; [INTERJECTION] surprise; pleasuretion foron for
auditor	accounts expert accounts by expert; without shameives; [INTERJECTION] surprise; pleasuretion foron for
audits	looking over of accounts by expert; without shameives; [INTERJECTION] surprise; pleasuretion foron for
august	Augustg over of accounts by expert; without shameives; [INTERJECTION] surprise; pleasuretion foron for
aunt	father's or mother's sister expert; without shameives; [INTERJECTION] surprise; pleasuretion foron for
aunts	father's or mother's sistersexpert; without shameives; [INTERJECTION] surprise; pleasuretion foron for
aurora	Aurora's or mother's sistersexpert; without shameives; [INTERJECTION] surprise; pleasuretion foron for
auspicious	good sign (for future); feel good about future; given approvalECTION] surprise; pleasuretion foron for
auspiciously	as a good sign future); feel good about future; given approvalECTION] surprise; pleasuretion foron for
australia	Australia sign future); feel good about future; given approvalECTION] surprise; pleasuretion foron for
austria	Austriaia sign future); feel good about future; given approvalECTION] surprise; pleasuretion foron for
authentic	true, not falsefuture); feel good about future; given approvalECTION] surprise; pleasuretion foron for
author	writernot falsefuture); feel good about future; given approvalECTION] surprise; pleasuretion foron for
authorisation	authority falsefuture); feel good about future; given approvalECTION] surprise; pleasuretion foron for
authorise	give authorityefuture); feel good about future; given approvalECTION] surprise; pleasuretion foron for
authorised	given authorityfuture); feel good about future; given approvalECTION] surprise; pleasuretion foron for
authorises	gives authorityfuture); feel good about future; given approvalECTION] surprise; pleasuretion foron for
authorising	giving authorityuture); feel good about future; given approvalECTION] surprise; pleasuretion foron for
authorities	authoritiesorityuture); feel good about future; given approvalECTION] surprise; pleasuretion foron for
authority	authorityesorityuture); feel good about future; given approvalECTION] surprise; pleasuretion foron for
authorization	authorityesorityuture); feel good about future; given approvalECTION] surprise; pleasuretion foron for
authorizations	given authorityyuture); feel good about future; given approvalECTION] surprise; pleasuretion foron for
authorize	give authorityyyuture); feel good about future; given approvalECTION] surprise; pleasuretion foron for
authorized	given authorityyuture); feel good about future; given approvalECTION] surprise; pleasuretion foron for
authorizes	gives authorityyuture); feel good about future; given approvalECTION] surprise; pleasuretion foron for
authorizing	giving authorityuture); feel good about future; given approvalECTION] surprise; pleasuretion foron for
authors	writersauthorityuture); feel good about future; given approvalECTION] surprise; pleasuretion foron for
autobiographies	writer's histories of themselvesd about future; given approvalECTION] surprise; pleasuretion foron for
autobiography	writer's history of himselfelvesd about future; given approvalECTION] surprise; pleasuretion foron for
autobus	autobuss history of himselfelvesd about future; given approvalECTION] surprise; pleasuretion foron for
autobuses	autobuseshistory of himselfelvesd about future; given approvalECTION] surprise; pleasuretion foron for
autocrat	ruler with complete powerlfelvesd about future; given approvalECTION] surprise; pleasuretion foron for
autocrats	rulers with complete powerfelvesd about future; given approvalECTION] surprise; pleasuretion foron for
autograph	signed name complete powerfelvesd about future; given approvalECTION] surprise; pleasuretion foron for
autographs	signed namescomplete powerfelvesd about future; given approvalECTION] surprise; pleasuretion foron for
automate	make automaticmplete powerfelvesd about future; given approvalECTION] surprise; pleasuretion foron for
automated	made automaticmplete powerfelvesd about future; given approvalECTION] surprise; pleasuretion foron for
automates	makes automaticplete powerfelvesd about future; given approvalECTION] surprise; pleasuretion foron for
automatic	automaticomaticplete powerfelvesd about future; given approvalECTION] surprise; pleasuretion foron for
automatically	automaticallyicplete powerfelvesd about future; given approvalECTION] surprise; pleasuretion foron for
automatics	automaticsllyicplete powerfelvesd about future; given approvalECTION] surprise; pleasuretion foron for
automating	automating; making automaticlvesd about future; given approvalECTION] surprise; pleasuretion foron for
automobile	automobile; making automaticlvesd about future; given approvalECTION] surprise; pleasuretion foron for
automobiles	automobiles making automaticlvesd about future; given approvalECTION] surprise; pleasuretion foron for
autumn	fallmobiles making automaticlvesd about future; given approvalECTION] surprise; pleasuretion foron for
auxiliaries	helpersiles making automaticlvesd about future; given approvalECTION] surprise; pleasuretion foron for
auxiliary	helpingiles making automaticlvesd about future; given approvalECTION] surprise; pleasuretion foron for
avail	usepingiles making automaticlvesd about future; given approvalECTION] surprise; pleasuretion foron for
availability	able to use; ready to be usedvesd about future; given approvalECTION] surprise; pleasuretion foron for
available	at hand; ready (to be used)edvesd about future; given approvalECTION] surprise; pleasuretion foron for
avails	makes useready (to be used)edvesd about future; given approvalECTION] surprise; pleasuretion foron for
avalanche	fall of snowdy (to be used)edvesd about future; given approvalECTION] surprise; pleasuretion foron for
avalanches	falls of snowy (to be used)edvesd about future; given approvalECTION] surprise; pleasuretion foron for
avarice	overpowering love of money)edvesd about future; given approvalECTION] surprise; pleasuretion foron for
avenue	roadpowering love of money)edvesd about future; given approvalECTION] surprise; pleasuretion foron for
avenues	roadsowering love of money)edvesd about future; given approvalECTION] surprise; pleasuretion foron for
average	general; middle value; [business] about future; given approvalECTION] surprise; pleasuretion foron for
averages	common numbers; [business]siness] about future; given approvalECTION] surprise; pleasuretion foron for
averaging	making normal; giving middle value; [business]; given approvalECTION] surprise; pleasuretion foron for
aversion	feeling of disgust formiddle value; [business]; given approvalECTION] surprise; pleasuretion foron for
aviary	bird-house disgust formiddle value; [business]; given approvalECTION] surprise; pleasuretion foron for
avoid	keep out of the way of; keep frome; [business]; given approvalECTION] surprise; pleasuretion foron for
avoided	kept out of the way of; keep frome; [business]; given approvalECTION] surprise; pleasuretion foron for
avoiding	keeping out of the way; keep frome; [business]; given approvalECTION] surprise; pleasuretion foron for
avoids	keeps out of the way of keep frome; [business]; given approvalECTION] surprise; pleasuretion foron for
await	be waiting; in store forkeep frome; [business]; given approvalECTION] surprise; pleasuretion foron for
awaited	was waiting; was in store forfrome; [business]; given approvalECTION] surprise; pleasuretion foron for
awaiting	being waiting; being in store fore; [business]; given approvalECTION] surprise; pleasuretion foron for
awaits	is waiting; is in store forre fore; [business]; given approvalECTION] surprise; pleasuretion foron for
awake	awakeiting; is in store forre fore; [business]; given approvalECTION] surprise; pleasuretion foron for
awaked	awakedting; is in store forre fore; [business]; given approvalECTION] surprise; pleasuretion foron for
awaken	awakenting; is in store forre fore; [business]; given approvalECTION] surprise; pleasuretion foron for
awakes	awakesting; is in store forre fore; [business]; given approvalECTION] surprise; pleasuretion foron for
awaking	awakinging; is in store forre fore; [business]; given approvalECTION] surprise; pleasuretion foron for
award	rewardging; is in store forre fore; [business]; given approvalECTION] surprise; pleasuretion foron for
awarded	rewardedng; is in store forre fore; [business]; given approvalECTION] surprise; pleasuretion foron for
awarding	make reward is in store forre fore; [business]; given approvalECTION] surprise; pleasuretion foron for
awards	rewardsward is in store forre fore; [business]; given approvalECTION] surprise; pleasuretion foron for
aware	consciousrd is in store forre fore; [business]; given approvalECTION] surprise; pleasuretion foron for
awareness	being consciousin store forre fore; [business]; given approvalECTION] surprise; pleasuretion foron for
awash	washed over in wavesore forre fore; [business]; given approvalECTION] surprise; pleasuretion foron for
away	awayed over in wavesore forre fore; [business]; given approvalECTION] surprise; pleasuretion foron for
awe	fear before in wavesore forre fore; [business]; given approvalECTION] surprise; pleasuretion foron for
awed	respectfully fearedsore forre fore; [business]; given approvalECTION] surprise; pleasuretion foron for
awesome	respectful feararedsore forre fore; [business]; given approvalECTION] surprise; pleasuretion foron for
awful	very badul feararedsore forre fore; [business]; given approvalECTION] surprise; pleasuretion foron for
awfully	very badul feararedsore forre fore; [business]; given approvalECTION] surprise; pleasuretion foron for
awhile	for some timeararedsore forre fore; [business]; given approvalECTION] surprise; pleasuretion foron for
awkward	poor design; hard to make use of not expert in control; [second]TION] surprise; pleasuretion foron for
awkwardly	poorly designed; as if hard to make use of; not expertly; [second]ON] surprise; pleasuretion foron for
awning	canvas roofgned; as if hard to make use of; not expertly; [second]ON] surprise; pleasuretion foron for
awnings	canvas roofsned; as if hard to make use of; not expertly; [second]ON] surprise; pleasuretion foron for
awoke	awokes roofsned; as if hard to make use of; not expertly; [second]ON] surprise; pleasuretion foron for
ax	tree cutting instrumenthard to make use of; not expertly; [second]ON] surprise; pleasuretion foron for
axe	tree cutting instrumenthard to make use of; not expertly; [second]ON] surprise; pleasuretion foron for
axes	tree cutting instrumenthard to make use of; not expertly; [second]ON] surprise; pleasuretion foron for
axiom	something true without reasoning; taken as true without argumentd]ON] surprise; pleasuretion foron for
axioms	things true without reasoning; taken as true without argumententd]ON] surprise; pleasuretion foron for
axis	line about which a body goes when turning round itself; [science]]ON] surprise; pleasuretion foron for
axle	wheel rodt which a body goes when turning round itself; [science]]ON] surprise; pleasuretion foron for
axles	wheel rods which a body goes when turning round itself; [science]]ON] surprise; pleasuretion foron for
axt	make a request; put a questionhen turning round itself; [science]]ON] surprise; pleasuretion foron for
